Date,downloads.Android,downloads.Android.todate,downloads.iOS,downloads.iOS.todate,downloads.todate,TAN.issued,TAN.issued.todate,TAN.users,TAN.users.todate,TAN.SIusers,TAN.SIusers.todate
2020-08-17,4956,4956,,0,4956,,0,,0,,0
2020-08-18,18272,23228,,0,23228,,0,,0,,0
2020-08-19,5296,28524,,0,28524,,0,0,0,,0
2020-08-20,4568,33092,,0,33092,,0,0,0,,0
2020-08-21,2446,35538,,0,35538,,0,0,0,,0
2020-08-22,1813,37351,,0,37351,,0,0,0,,0
2020-08-23,1740,39091,,0,39091,,0,0,0,,0
2020-08-24,1985,41076,,0,41076,,0,0,0,,0
2020-08-25,2601,43677,,0,43677,,0,0,0,,0
2020-08-26,1435,45112,,0,45112,,0,0,0,,0
2020-08-27,1115,46227,,0,46227,,0,1,1,,0
2020-08-28,818,47045,,0,47045,,0,0,1,,0
2020-08-29,746,47791,,0,47791,,0,0,1,,0
2020-08-30,1077,48868,,0,48868,,0,0,1,,0
2020-08-31,721,49589,,0,49589,,0,1,2,,0
2020-09-01,1761,51350,,0,51350,,0,2,4,,0
2020-09-02,1783,53133,,0,53133,,0,1,5,,0
2020-09-03,1497,54630,,0,54630,,0,1,6,,0
2020-09-04,1273,55903,,0,55903,,0,0,6,,0
2020-09-05,770,56673,,0,56673,,0,2,8,,0
2020-09-06,770,57443,,0,57443,,0,0,8,,0
2020-09-07,1079,58522,,0,58522,,0,0,8,,0
2020-09-08,801,59323,,0,59323,,0,3,11,,0
2020-09-09,1133,60456,,0,60456,,0,0,11,,0
2020-09-10,13616,74072,,0,74072,,0,1,12,,0
2020-09-11,5139,79211,,0,79211,,0,4,16,,0
2020-09-12,5070,84281,,0,84281,,0,1,17,,0
2020-09-13,4271,88552,,0,88552,,0,3,20,,0
2020-09-14,2745,91297,,0,91297,,0,4,24,,0
2020-09-15,1675,92972,,0,92972,,0,4,28,,0
2020-09-16,2088,95060,,0,95060,,0,4,32,,0
2020-09-17,1102,96162,,0,96162,,0,5,37,,0
2020-09-18,829,96991,,0,96991,,0,3,40,,0
2020-09-19,574,97565,,0,97565,,0,1,41,,0
2020-09-20,592,98157,,0,98157,,0,5,46,,0
2020-09-21,522,98679,,0,98679,,0,2,48,,0
2020-09-22,672,99351,,0,99351,,0,2,50,,0
2020-09-23,502,99853,,0,99853,,0,8,58,,0
2020-09-24,648,100501,,0,100501,,0,3,61,,0
2020-09-25,953,101454,,0,101454,14,14,7,68,,0
2020-09-26,649,102103,,0,102103,4,18,2,70,,0
2020-09-27,535,102638,,0,102638,14,32,7,77,,0
2020-09-28,614,103252,,0,103252,9,41,3,80,,0
2020-09-29,466,103718,,0,103718,12,53,5,85,,0
2020-09-30,676,104394,,0,104394,14,67,11,96,,0
2020-10-01,513,104907,,0,104907,22,89,17,113,,0
2020-10-02,649,105556,,0,105556,23,112,10,123,,0
2020-10-03,445,106001,,0,106001,37,149,18,141,,0
2020-10-04,441,106442,,0,106442,11,160,10,151,,0
2020-10-05,461,106903,,0,106903,14,174,5,156,,0
2020-10-06,1308,108211,,0,108211,16,190,7,163,,0
2020-10-07,1729,109940,,0,109940,21,211,11,174,,0
2020-10-08,2059,111999,,0,111999,41,252,16,190,,0
2020-10-09,2315,114314,,0,114314,61,313,27,217,,0
2020-10-10,1029,115343,,0,115343,41,354,25,242,,0
2020-10-11,3453,118796,,0,118796,38,392,14,256,,0
2020-10-12,1804,120600,,0,120600,44,436,20,276,,0
2020-10-13,2761,123361,,0,123361,50,486,26,302,,0
2020-10-14,5777,129138,,0,129138,60,546,30,332,,0
2020-10-15,2941,132079,,0,132079,79,625,47,379,,0
2020-10-16,2521,134600,,0,134600,74,699,41,420,,0
2020-10-17,1796,136396,,0,136396,146,845,79,499,,0
2020-10-18,3187,139583,,0,139583,172,1017,71,570,,0
2020-10-19,11642,151225,,0,151225,152,1169,62,632,,0
2020-10-20,3212,154437,,0,154437,169,1338,104,736,,0
2020-10-21,3311,157748,,0,157748,187,1525,103,839,,0
2020-10-22,3264,161012,,0,161012,221,1746,109,948,,0
2020-10-23,1771,162783,,0,162783,223,1969,111,1059,,0
2020-10-24,1534,164317,,0,164317,182,2151,118,1177,,0
2020-10-25,1440,165757,,0,165757,166,2317,102,1279,,0
2020-10-26,1372,167129,,0,167129,177,2494,102,1381,,0
2020-10-27,1241,168370,,0,168370,203,2697,107,1488,,0
2020-10-28,1444,169814,,0,169814,247,2944,133,1621,,0
2020-10-29,1877,171691,,0,171691,211,3155,126,1747,,0
2020-10-30,925,172616,,0,172616,172,3327,101,1848,,0
2020-10-31,511,173127,,0,173127,274,3601,173,2021,,0
2020-11-01,557,173684,,0,173684,184,3785,101,2122,,0
2020-11-02,704,174388,,0,174388,209,3994,118,2240,,0
2020-11-03,487,174875,,0,174875,209,4203,97,2337,,0
2020-11-04,412,175287,,0,175287,220,4423,116,2453,,0
2020-11-05,333,175620,,0,175620,186,4609,105,2558,,0
2020-11-06,286,175906,,0,175906,173,4782,99,2657,,0
2020-11-07,221,176127,,0,176127,172,4954,99,2756,,0
2020-11-08,171,176298,,0,176298,202,5156,108,2864,,0
2020-11-09,238,176536,,0,176536,77,5233,37,2901,,0
2020-11-10,266,176802,,0,176802,220,5453,112,3013,,0
2020-11-11,390,177192,,0,177192,245,5698,132,3145,,0
2020-11-12,298,177490,,0,177490,182,5880,101,3246,,0
2020-11-13,339,177829,,0,177829,179,6059,94,3340,,0
2020-11-14,240,178069,,0,178069,182,6241,88,3428,,0
2020-11-15,254,178323,,0,178323,96,6337,52,3480,,0
2020-11-16,233,178556,,0,178556,109,6446,62,3542,,0
2020-11-17,258,178814,,0,178814,164,6610,115,3657,,0
2020-11-18,252,179066,,0,179066,165,6775,100,3757,,0
2020-11-19,261,179327,,0,179327,172,6947,116,3873,,0
2020-11-20,320,179647,,0,179647,146,7093,83,3956,,0
2020-11-21,216,179863,,0,179863,126,7219,89,4045,,0
2020-11-22,230,180093,,0,180093,79,7298,49,4094,,0
2020-11-23,192,180285,,0,180285,79,7377,41,4135,,0
2020-11-24,180,180465,,0,180465,141,7518,105,4240,,0
2020-11-25,174,180639,,0,180639,188,7706,122,4362,,0
2020-11-26,202,180841,,0,180841,132,7838,85,4447,,0
2020-11-27,178,181019,,0,181019,140,7978,98,4545,,0
2020-11-28,118,181137,,0,181137,86,8064,56,4601,,0
2020-11-29,168,181305,,0,181305,68,8132,43,4644,,0
2020-11-30,153,181458,,0,181458,68,8200,41,4685,,0
2020-12-01,155,181613,,0,181613,147,8347,102,4787,,0
2020-12-02,140,181753,,0,181753,150,8497,99,4886,,0
2020-12-03,112,181865,,0,181865,129,8626,92,4978,,0
2020-12-04,115,181980,,0,181980,112,8738,76,5054,,0
2020-12-05,97,182077,,0,182077,111,8849,79,5133,,0
2020-12-06,133,182210,,0,182210,87,8936,61,5194,,0
2020-12-07,126,182336,,0,182336,64,9000,35,5229,,0
2020-12-08,131,182467,,0,182467,123,9123,76,5305,,0
2020-12-09,123,182590,,0,182590,155,9278,95,5400,,0
2020-12-10,112,182702,,0,182702,103,9381,63,5463,,0
2020-12-11,124,182826,,0,182826,90,9471,61,5524,,0
2020-12-12,123,182949,,0,182949,88,9559,70,5594,,0
2020-12-13,10322,193271,,0,193271,81,9640,59,5653,,0
2020-12-14,41506,234777,,0,234777,488,10128,104,5757,,0
2020-12-15,23865,258642,,0,258642,777,10905,124,5881,,0
2020-12-16,13682,272324,,0,272324,938,11843,183,6064,,0
2020-12-17,10261,282585,,0,282585,866,12709,116,6180,,0
2020-12-18,10666,293251,,0,293251,1004,13713,142,6322,,0
2020-12-19,9985,303236,,0,303236,752,14465,107,6429,,0
2020-12-20,6501,309737,,0,309737,316,14781,48,6477,,0
2020-12-21,4912,314649,,0,314649,754,15535,99,6576,,0
2020-12-22,4134,318783,,0,318783,1645,17180,190,6766,,0
2020-12-23,2949,321732,,0,321732,1633,18813,211,6977,,0
2020-12-24,1379,323111,,0,323111,1462,20275,143,7120,,0
2020-12-25,1061,324172,,0,324172,328,20603,52,7172,,0
2020-12-26,824,324996,,0,324996,399,21002,66,7238,,0
2020-12-27,654,325650,,0,325650,413,21415,71,7309,,0
2020-12-28,488,326138,,0,326138,1321,22736,154,7463,,0
2020-12-29,498,326636,,0,326636,1855,24591,221,7684,,0
2020-12-30,468,327104,,0,327104,1973,26564,233,7917,,0
2020-12-31,366,327470,,0,327470,1521,28085,191,8108,,0
2021-01-01,300,327770,,0,327770,309,28394,34,8142,,0
2021-01-02,333,328103,,0,328103,474,28868,65,8207,,0
2021-01-03,337,328440,,0,328440,487,29355,70,8277,,0
2021-01-04,301,328741,,0,328741,1601,30956,202,8479,,0
2021-01-05,284,329025,,0,329025,2730,33686,274,8753,,0
2021-01-06,272,329297,,0,329297,2163,35849,237,8990,,0
2021-01-07,239,329536,,0,329536,1631,37480,168,9158,,0
2021-01-08,283,329819,,0,329819,1558,39038,169,9327,,0
2021-01-09,235,330054,,0,330054,579,39617,75,9402,,0
2021-01-10,212,330266,,0,330266,290,39907,42,9444,,0
2021-01-11,201,330467,,0,330467,1193,41100,105,9549,,0
2021-01-12,169,330636,,0,330636,1732,42832,162,9711,,0
2021-01-13,183,330819,,0,330819,1390,44222,150,9861,,0
2021-01-14,251,331070,,0,331070,1181,45403,117,9978,,0
2021-01-15,236,331306,,0,331306,1225,46628,94,10072,,0
2021-01-16,189,331495,,0,331495,542,47170,64,10136,,0
2021-01-17,171,331666,,0,331666,252,47422,37,10173,,0
2021-01-18,151,331817,,0,331817,1193,48615,114,10287,,0
2021-01-19,141,331958,,0,331958,1389,50004,136,10423,,0
2021-01-20,138,332096,,0,332096,1162,51166,115,10538,,0
2021-01-21,123,332219,,0,332219,1076,52242,109,10647,,0
2021-01-22,240,332459,,0,332459,1156,53398,121,10768,,0
2021-01-23,142,332601,,0,332601,515,53913,53,10821,,0
2021-01-24,142,332743,,0,332743,237,54150,42,10863,,0
2021-01-25,165,332908,,0,332908,1177,55327,117,10980,,0
2021-01-26,134,333042,,0,333042,1539,56866,161,11141,,0
2021-01-27,114,333156,,0,333156,1263,58129,115,11256,,0
2021-01-28,99,333255,,0,333255,1095,59224,125,11381,,0
2021-01-29,118,333373,,0,333373,983,60207,104,11485,,0
2021-01-30,211,333584,,0,333584,544,60751,51,11536,,0
2021-01-31,83,333667,,0,333667,299,61050,36,11572,,0
2021-02-01,102,333769,,0,333769,1179,62229,106,11678,,0
2021-02-02,92,333861,,0,333861,1297,63526,119,11797,,0
2021-02-03,88,333949,,0,333949,1070,64596,87,11884,,0
2021-02-04,93,334042,,0,334042,804,65400,69,11953,,0
2021-02-05,78,334120,,0,334120,726,66126,64,12017,,0
2021-02-06,57,334177,,0,334177,567,66693,58,12075,,0
2021-02-07,61,334238,,0,334238,246,66939,29,12104,,0
2021-02-08,61,334299,,0,334299,291,67230,29,12133,,0
2021-02-09,77,334376,,0,334376,1235,68465,77,12210,,0
2021-02-10,64,334440,,0,334440,1264,69729,806,13016,,0
2021-02-11,61,334501,,0,334501,1047,70776,1076,14092,,0
2021-02-12,139,334640,,0,334640,951,71727,954,15046,,0
2021-02-13,64,334704,,0,334704,625,72352,957,16003,,0
2021-02-14,44,334748,,0,334748,333,72685,681,16684,,0
2021-02-15,43,334791,,0,334791,657,73342,1010,17694,,0
2021-02-16,50,334841,,0,334841,974,74316,2059,19753,,0
2021-02-17,42,334883,,0,334883,769,75085,2095,21848,,0
2021-02-18,55,334938,,0,334938,717,75802,2071,23919,,0
2021-02-19,55,334993,,0,334993,850,76652,2220,26139,,0
2021-02-20,48,335041,,0,335041,407,77059,1943,28082,,0
2021-02-21,32,335073,,0,335073,234,77293,1241,29323,,0
2021-02-22,58,335131,,0,335131,702,77995,1424,30747,,0
2021-02-23,50,335181,,0,335181,969,78964,2150,32897,,0
2021-02-24,43,335224,,0,335224,744,79708,2154,35051,,0
2021-02-25,38,335262,,0,335262,834,80542,2179,37230,,0
2021-02-26,36,335298,,0,335298,849,81391,2240,39470,,0
2021-02-27,32,335330,,0,335330,422,81813,1950,41420,,0
2021-02-28,55,335385,,0,335385,213,82026,1217,42637,,0
2021-03-01,42,335427,,0,335427,589,82615,1397,44034,,0
2021-03-02,52,335479,,0,335479,1028,83643,2298,46332,,0
2021-03-03,42,335521,,0,335521,930,84573,2330,48662,,0
2021-03-04,54,335575,,0,335575,758,85331,2028,50690,,0
2021-03-05,47,335622,,0,335622,786,86117,2270,52960,,0
2021-03-06,43,335665,,0,335665,382,86499,2017,54977,,0
2021-03-07,36,335701,,0,335701,180,86679,1275,56252,,0
2021-03-08,31,335732,,0,335732,633,87312,1494,57746,,0
2021-03-09,53,335785,,0,335785,824,88136,2691,60437,,0
2021-03-10,43,335828,,0,335828,762,88898,2769,63206,,0
2021-03-11,45,335873,,0,335873,664,89562,2771,65977,,0
2021-03-12,38,335911,,0,335911,549,90111,3145,69122,,0
2021-03-13,36,335947,,0,335947,692,90803,2746,71868,,0
2021-03-14,27,335974,,0,335974,183,90986,1639,73507,,0
2021-03-15,47,336021,,0,336021,772,91758,2062,75569,,0
2021-03-16,37,336058,,0,336058,717,92475,3518,79087,,0
2021-03-17,34,336092,,0,336092,981,93456,3667,82754,,0
2021-03-18,50,336142,,0,336142,820,94276,3452,86206,,0
2021-03-19,40,336182,,0,336182,915,95191,3863,90069,,0
2021-03-20,31,336213,,0,336213,480,95671,3502,93571,,0
2021-03-21,34,336247,,0,336247,249,95920,2112,95683,,0
2021-03-22,30,336277,,0,336277,777,96697,2532,98215,,0
2021-03-23,60,336337,,0,336337,1201,97898,4636,102851,,0
2021-03-24,58,336395,,0,336395,1061,98959,4904,107755,,0
2021-03-25,47,336442,,0,336442,931,99890,4721,112476,,0
2021-03-26,35,336477,,0,336477,1090,100980,4747,117223,,0
2021-03-27,35,336512,,0,336512,654,101634,4143,121366,,0
2021-03-28,44,336556,,0,336556,277,101911,2534,123900,,0
2021-03-29,46,336602,,0,336602,932,102843,3010,126910,,0
2021-03-30,50,336652,,0,336652,1368,104211,4773,131683,,0
2021-03-31,55,336707,,0,336707,1228,105439,5085,136768,,0
2021-04-01,49,336756,,0,336756,1062,106501,4702,141470,,0
2021-04-02,50,336806,,0,336806,1106,107607,4113,145583,,0
2021-04-03,29,336835,,0,336835,694,108301,2854,148437,,0
2021-04-04,34,336869,,0,336869,263,108564,2329,150766,,0
2021-04-05,43,336912,,0,336912,235,108799,2168,152934,,0
2021-04-06,47,336959,,0,336959,1028,109827,3067,156001,,0
2021-04-07,39,336998,,0,336998,1370,111197,5113,161114,103,103
2021-04-08,38,337036,,0,337036,1136,112333,5121,166235,93,196
2021-04-09,41,337077,,0,337077,1128,113461,5241,171476,85,281
2021-04-10,34,337111,,0,337111,556,114017,4070,175546,42,323
2021-04-11,31,337142,,0,337142,262,114279,2497,178043,16,339
2021-04-12,46,337188,,0,337188,896,115175,2898,180941,60,399
2021-04-13,30,337218,,0,337218,1130,116305,5233,186174,80,479
2021-04-14,87,337305,,0,337305,781,117086,5130,191304,51,530
2021-04-15,102,337407,,0,337407,734,117820,4529,195833,36,566
2021-04-16,86,337493,,0,337493,660,118480,4463,200296,32,598
2021-04-17,46,337539,,0,337539,418,118898,3999,204295,40,638
2021-04-18,49,337588,,0,337588,185,119083,2354,206649,14,652
2021-04-19,45,337633,,0,337633,605,119688,3218,209867,34,686
2021-04-20,60,337693,,0,337693,876,120564,5349,215216,48,734
2021-04-21,36,337729,,0,337729,659,121223,5588,220804,37,771
2021-04-22,32,337761,,0,337761,755,121978,4623,225427,49,820
2021-04-23,43,337804,,0,337804,743,122721,4662,230089,44,864
2021-04-24,31,337835,,0,337835,386,123107,3891,233980,26,890
2021-04-25,32,337867,,0,337867,155,123262,2304,236284,17,907
2021-04-26,48,337915,,0,337915,680,123942,2496,238780,43,950
2021-04-27,35,337950,,0,337950,376,124318,4384,243164,26,976
2021-04-28,42,337992,,0,337992,796,125114,4409,247573,42,1018
2021-04-29,33,338025,,0,338025,878,125992,3297,250870,68,1086
2021-04-30,26,338051,,0,338051,906,126898,3409,254279,70,1156
2021-05-01,20,338071,,0,338071,307,127205,2831,257110,24,1180
2021-05-02,44,338115,,0,338115,174,127379,1768,258878,15,1195
2021-05-03,47,338162,,0,338162,755,128134,2424,261302,49,1244
2021-05-04,45,338207,,0,338207,861,128995,4176,265478,59,1303
2021-05-05,35,338242,,0,338242,737,129732,3529,269007,35,1338
2021-05-06,67,338309,,0,338309,574,130306,3091,272098,20,1358
2021-05-07,78,338387,,0,338387,601,130907,3145,275243,34,1392
2021-05-08,34,338421,,0,338421,283,131190,2764,278007,13,1405
2021-05-09,45,338466,,0,338466,118,131308,1605,279612,6,1411
2021-05-10,50,338516,,0,338516,439,131747,1936,281548,24,1435
2021-05-11,47,338563,,0,338563,640,132387,3153,284701,25,1460
2021-05-12,42,338605,,0,338605,464,132851,2700,287401,39,1499
2021-05-13,62,338667,,0,338667,412,133263,2142,289543,23,1522
2021-05-14,73,338740,,0,338740,466,133729,1852,291395,30,1552
2021-05-15,36,338776,,0,338776,238,133967,1807,293202,21,1573
2021-05-16,46,338822,,0,338822,94,134061,997,294199,5,1578
2021-05-17,48,338870,,0,338870,445,134506,1189,295388,28,1606
2021-05-18,53,338923,,0,338923,507,135013,2271,297659,34,1640
2021-05-19,50,338973,,0,338973,323,135336,2061,299720,10,1650
2021-05-20,37,339010,,0,339010,275,135611,1821,301541,18,1668
2021-05-21,51,339061,,0,339061,341,135952,1817,303358,11,1679
2021-05-22,33,339094,,0,339094,167,136119,1423,304781,9,1688
2021-05-23,47,339141,,0,339141,73,136192,829,305610,,1688
2021-05-24,40,339181,,0,339181,282,136474,662,306272,16,1704
2021-05-25,42,339223,,0,339223,340,136814,1027,307299,20,1724
2021-05-26,48,339271,,0,339271,351,137165,1504,308803,29,1753
2021-05-27,38,339309,,0,339309,272,137437,1385,310188,15,1768
2021-05-28,21,339330,,0,339330,321,137758,1245,311433,23,1791
2021-05-29,29,339359,,0,339359,118,137876,1050,312483,9,1800
2021-05-30,26,339385,,0,339385,75,137951,713,313196,2,1802
2021-05-31,43,339428,,0,339428,267,138218,350,313546,11,1813
2021-06-01,50,339478,,0,339478,357,138575,21,313567,18,1831
2021-06-02,55,339533,,0,339533,242,138817,85,313652,21,1852
2021-06-03,64,339597,,0,339597,244,139061,12,313664,15,1867
2021-06-04,54,339651,,0,339651,212,139273,586,314250,11,1878
2021-06-05,42,339693,,0,339693,163,139436,704,314954,9,1887
2021-06-06,35,339728,,0,339728,47,139483,442,315396,3,1890
2021-06-07,52,339780,,0,339780,200,139683,487,315883,15,1905
2021-06-08,59,339839,,0,339839,244,139927,662,316545,13,1918
2021-06-09,59,339898,,0,339898,183,140110,561,317106,11,1929
2021-06-10,52,339950,,0,339950,110,140220,539,317645,7,1936
2021-06-11,95,340045,,0,340045,108,140328,503,318148,5,1941
2021-06-12,54,340099,,0,340099,80,140408,442,318590,2,1943
2021-06-13,40,340139,,0,340139,24,140432,336,318926,1,1944
2021-06-14,38,340177,,0,340177,95,140527,335,319261,1,1945
2021-06-15,69,340246,,0,340246,90,140617,432,319693,2,1947
2021-06-16,54,340300,,0,340300,73,140690,456,320149,2,1949
2021-06-17,52,340352,,0,340352,72,140762,348,320497,1,1950
2021-06-18,62,340414,,0,340414,72,140834,323,320820,1,1951
2021-06-19,46,340460,,0,340460,16,140850,283,321103,,1951
2021-06-20,35,340495,,0,340495,12,140862,228,321331,1,1952
2021-06-21,55,340550,,0,340550,52,140914,275,321606,1,1953
2021-06-22,67,340617,,0,340617,46,140960,297,321903,,1953
2021-06-23,71,340688,,0,340688,31,140991,303,322206,1,1954
2021-06-24,79,340767,,0,340767,34,141025,288,322494,1,1955
2021-06-25,38,340805,,0,340805,11,141036,237,322731,,1955
2021-06-26,39,340844,,0,340844,12,141048,235,322966,1,1956
2021-06-27,33,340877,,0,340877,3,141051,219,323185,,1956
2021-06-28,51,340928,,0,340928,31,141082,228,323413,,1956
2021-06-29,54,340982,,0,340982,38,141120,302,323715,1,1957
2021-06-30,58,341040,,0,341040,21,141141,288,324003,2,1959
2021-07-01,161,341201,,0,341201,19,141160,324,324327,,1959
2021-07-02,103,341304,,0,341304,26,141186,392,324719,3,1962
2021-07-03,64,341368,,0,341368,7,141193,419,325138,,1962
2021-07-04,61,341429,,0,341429,6,141199,417,325555,,1962
2021-07-05,110,341539,,0,341539,43,141242,530,326085,1,1963
2021-07-06,188,341727,,0,341727,66,141308,778,326863,3,1966
2021-07-07,152,341879,,0,341879,69,141377,1025,327888,1,1967
2021-07-08,143,342022,,0,342022,76,141453,1331,329219,4,1971
2021-07-09,145,342167,,0,342167,73,141526,1623,330842,2,1973
2021-07-10,113,342280,,0,342280,20,141546,1728,332570,1,1974
2021-07-11,121,342401,,0,342401,8,141554,2105,334675,,1974
2021-07-12,127,342528,,0,342528,71,141625,2245,336920,2,1976
2021-07-13,140,342668,,0,342668,70,141695,2275,339195,2,1978
2021-07-14,133,342801,,0,342801,47,141742,2436,341631,,1978
2021-07-15,149,342950,,0,342950,60,141802,2593,344224,3,1981
2021-07-16,169,343119,,0,343119,58,141860,2247,346471,1,1982
2021-07-17,99,343218,,0,343218,22,141882,2011,348482,,1982
2021-07-18,84,343302,,0,343302,7,141889,1763,350245,1,1983
2021-07-19,51,343353,,0,343353,73,141962,1623,351868,3,1986
2021-07-20,85,343438,,0,343438,99,142061,1655,353523,3,1989
2021-07-21,89,343527,,0,343527,66,142127,1524,355047,1,1990
2021-07-22,115,343642,,0,343642,51,142178,1437,356484,,1990
2021-07-23,174,343816,,0,343816,75,142253,1294,357778,3,1993
2021-07-24,111,343927,,0,343927,31,142284,1028,358806,2,1995
2021-07-25,113,344040,,0,344040,17,142301,747,359553,1,1996
2021-07-26,165,344205,,0,344205,93,142394,816,360369,1,1997
2021-07-27,128,344333,,0,344333,69,142463,1020,361389,6,2003
2021-07-28,107,344440,,0,344440,100,142563,1015,362404,,2003
2021-07-29,80,344520,,0,344520,101,142664,851,363255,3,2006
2021-07-30,156,344676,,0,344676,119,142783,801,364056,3,2009
2021-07-31,111,344787,,0,344787,51,142834,787,364843,,2009
2021-08-01,110,344897,,0,344897,29,142863,503,365346,3,2012
2021-08-02,134,345031,,0,345031,159,143022,494,365840,4,2016
2021-08-03,106,345137,,0,345137,128,143150,811,366651,2,2018
2021-08-04,81,345218,,0,345218,122,143272,788,367439,3,2021
2021-08-05,125,345343,,0,345343,127,143399,770,368209,2,2023
2021-08-06,146,345489,,0,345489,119,143518,804,369013,4,2027
2021-08-07,75,345564,,0,345564,61,143579,611,369624,5,2032
2021-08-08,101,345665,,0,345665,48,143627,468,370092,2,2034
2021-08-09,69,345734,,0,345734,179,143806,530,370622,8,2042
2021-08-10,96,345830,,0,345830,217,144023,810,371432,9,2051
2021-08-11,76,345906,,0,345906,220,144243,777,372209,8,2059
2021-08-12,118,346024,,0,346024,176,144419,767,372976,4,2063
2021-08-13,114,346138,,0,346138,224,144643,809,373785,14,2077
2021-08-14,76,346214,,0,346214,86,144729,660,374445,2,2079
2021-08-15,76,346290,,0,346290,43,144772,438,374883,3,2082
2021-08-16,75,346365,,0,346365,278,145050,623,375506,13,2095
2021-08-17,92,346457,,0,346457,321,145371,992,376498,15,2110
2021-08-18,84,346541,,0,346541,351,145722,878,377376,10,2120
2021-08-19,75,346616,,0,346616,298,146020,875,378251,14,2134
2021-08-20,106,346722,,0,346722,331,146351,848,379099,12,2146
2021-08-21,80,346802,,0,346802,215,146566,772,379871,11,2157
2021-08-22,89,346891,,0,346891,93,146659,438,380309,4,2161
2021-08-23,98,346989,,0,346989,396,147055,668,380977,14,2175
2021-08-24,90,347079,,0,347079,472,147527,1183,382160,23,2198
2021-08-25,79,347158,,0,347158,467,147994,1166,383326,15,2213
2021-08-26,99,347257,,0,347257,479,148473,1066,384392,17,2230
2021-08-27,119,347376,,0,347376,486,148959,1114,385506,25,2255
2021-08-28,108,347484,,0,347484,235,149194,1023,386529,13,2268
2021-08-29,125,347609,,0,347609,117,149311,519,387048,2,2270
2021-08-30,91,347700,,0,347700,468,149779,733,387781,15,2285
2021-08-31,119,347819,,0,347819,700,150479,1489,389270,20,2305
2021-09-01,85,347904,,0,347904,599,151078,1384,390654,18,2323
2021-09-02,101,348005,,0,348005,552,151630,1162,391816,23,2346
2021-09-03,73,348078,,0,348078,657,152287,1528,393344,23,2369
2021-09-04,82,348160,,0,348160,289,152576,1146,394490,8,2377
2021-09-05,102,348262,,0,348262,211,152787,644,395134,13,2390
2021-09-06,213,348475,,0,348475,754,153541,726,395860,21,2411
2021-09-07,225,348700,,0,348700,955,154496,1704,397564,38,2449
2021-09-08,200,348900,,0,348900,914,155410,1405,398969,25,2474
2021-09-09,220,349120,,0,349120,931,156341,1289,400258,40,2514
2021-09-10,228,349348,,0,349348,914,157255,1292,401550,24,2538
2021-09-11,176,349524,,0,349524,505,157760,1096,402646,18,2556
2021-09-12,263,349787,,0,349787,259,158019,568,403214,12,2568
2021-09-13,527,350314,,0,350314,1171,159190,709,403923,31,2599
2021-09-14,889,351203,,0,351203,1221,160411,1480,405403,40,2639
2021-09-15,1003,352206,,0,352206,1190,161601,1218,406621,44,2683
2021-09-16,676,352882,,0,352882,594,162195,1034,407655,20,2703
2021-09-17,546,353428,,0,353428,1472,163667,1093,408748,51,2754
2021-09-18,344,353772,,0,353772,514,164181,821,409569,24,2778
2021-09-19,291,354063,,0,354063,292,164473,360,409929,15,2793
2021-09-20,325,354388,,0,354388,1090,165563,807,410736,31,2824
2021-09-21,300,354688,,0,354688,1111,166674,1220,411956,36,2860
2021-09-22,287,354975,,0,354975,933,167607,1083,413039,35,2895
2021-09-23,221,355196,,0,355196,816,168423,1001,414040,16,2911
2021-09-24,263,355459,,0,355459,911,169334,1080,415120,26,2937
2021-09-25,188,355647,,0,355647,421,169755,830,415950,23,2960
2021-09-26,160,355807,,0,355807,259,170014,493,416443,12,2972
2021-09-27,243,356050,,0,356050,795,170809,676,417119,26,2998
2021-09-28,192,356242,,0,356242,1200,172009,1369,418488,44,3042
2021-09-29,169,356411,,0,356411,913,172922,1167,419655,29,3071
2021-09-30,154,356565,,0,356565,898,173820,1048,420703,34,3105
2021-10-01,161,356726,,0,356726,825,174645,1056,421759,31,3136
2021-10-02,129,356855,,0,356855,464,175109,848,422607,13,3149
2021-10-03,139,356994,,0,356994,236,175345,482,423089,9,3158
2021-10-04,154,357148,,0,357148,881,176226,670,423759,33,3191
2021-10-05,138,357286,,0,357286,1069,177295,1399,425158,35,3226
2021-10-06,148,357434,,0,357434,879,178174,1235,426393,34,3260
2021-10-07,173,357607,,0,357607,721,178895,1135,427528,20,3280
2021-10-08,132,357739,,0,357739,807,179702,1339,428867,22,3302
2021-10-09,109,357848,,0,357848,431,180133,1149,430016,21,3323
2021-10-10,95,357943,,0,357943,178,180311,663,430679,10,3333
2021-10-11,121,358064,,0,358064,875,181186,846,431525,26,3359
2021-10-12,114,358178,,0,358178,1122,182308,1771,433296,44,3403
2021-10-13,118,358296,,0,358296,985,183293,1670,434966,26,3429
2021-10-14,128,358424,,0,358424,998,184291,1645,436611,42,3471
2021-10-15,127,358551,,0,358551,1236,185527,1774,438385,37,3508
2021-10-16,92,358643,,0,358643,642,186169,1599,439984,26,3534
2021-10-17,100,358743,,0,358743,333,186502,1010,440994,16,3550
2021-10-18,118,358861,,0,358861,1523,188025,1359,442353,54,3604
2021-10-19,101,358962,,0,358962,1938,189963,2565,444918,78,3682
2021-10-20,156,359118,,0,359118,1690,191653,2476,447394,74,3756
2021-10-21,106,359224,,0,359224,1752,193405,2503,449897,89,3845
2021-10-22,149,359373,,0,359373,1957,195362,2679,452576,83,3928
2021-10-23,125,359498,,0,359498,1467,196829,2611,455187,65,3993
2021-10-24,110,359608,,0,359608,647,197476,1636,456823,23,4016
2021-10-25,111,359719,,0,359719,1981,199457,1957,458780,90,4106
2021-10-26,,359719,,0,359719,2901,202358,3867,462647,124,4230
2021-10-27,,359719,,0,359719,2469,204827,4002,466649,97,4327
2021-10-28,,359719,,0,359719,2289,207116,3660,470309,92,4419
2021-10-29,,359719,,0,359719,2584,209700,3858,474167,97,4516
2021-10-30,,359719,,0,359719,1674,211374,3533,477700,75,4591
2021-10-31,,359719,,0,359719,1035,212409,2102,479802,46,4637
2021-11-01,,359719,,0,359719,1159,213568,2223,482025,32,4669
2021-11-02,,359719,,0,359719,2749,216317,4055,486080,108,4777
2021-11-03,,359719,,0,359719,4195,220512,5852,491932,145,4922
2021-11-04,,359719,,0,359719,3587,224099,5988,497920,130,5052
2021-11-05,,359719,,0,359719,3212,227311,5901,503821,136,5188
2021-11-06,,359719,,0,359719,2273,229584,5485,509306,94,5282
2021-11-07,,359719,,0,359719,1188,230772,3247,512553,53,5335
2021-11-08,,359719,,0,359719,2853,233625,4060,516613,96,5431
2021-11-09,,359719,,0,359719,4087,237712,7646,524259,156,5587
2021-11-10,,359719,,0,359719,3390,241102,8204,532463,116,5703
2021-11-11,,359719,,0,359719,3137,244239,7476,539939,110,5813
2021-11-12,,359719,,0,359719,3254,247493,8048,547987,122,5935
2021-11-13,,359719,,0,359719,2303,249796,7063,555050,96,6031
2021-11-14,,359719,,0,359719,1754,251550,3898,558948,71,6102
2021-11-15,,359719,,0,359719,3255,254805,6275,565223,125,6227
2021-11-16,,359719,,0,359719,4018,258823,10019,575242,129,6356
2021-11-17,,359719,,0,359719,3334,262157,10560,585802,106,6462
2021-11-18,,359719,,0,359719,3199,265356,9549,595351,109,6571
2021-11-19,,359719,,0,359719,2981,268337,10024,605375,102,6673
2021-11-20,,359719,,0,359719,2146,270483,9886,615261,75,6748
2021-11-21,,359719,,0,359719,1336,271819,5284,620545,39,6787
2021-11-22,,359719,,0,359719,2905,274724,6580,627125,77,6864
<hr><center>nginx/1-16-1</center>,,359719,1161,1161,360880,,274724,,627125,,6864
