Date,downloads.Android,downloads.Android.todate,downloads.iOS,downloads.iOS.todate,downloads.todate,TAN.issued,TAN.issued.todate,TAN.users,TAN.users.todate,TAN.SIusers,TAN.SIusers.todate
2020-08-17,4956,4956,,0,4956,,0,,0,,0
2020-08-18,18272,23228,,0,23228,,0,,0,,0
2020-08-19,5296,28524,,0,28524,,0,0,0,,0
2020-08-20,4568,33092,,0,33092,,0,0,0,,0
2020-08-21,2446,35538,,0,35538,,0,0,0,,0
2020-08-22,1813,37351,,0,37351,,0,0,0,,0
2020-08-23,1740,39091,,0,39091,,0,0,0,,0
2020-08-24,1985,41076,,0,41076,,0,0,0,,0
2020-08-25,2601,43677,,0,43677,,0,0,0,,0
2020-08-26,1435,45112,,0,45112,,0,0,0,,0
2020-08-27,1115,46227,,0,46227,,0,1,1,,0
2020-08-28,818,47045,,0,47045,,0,0,1,,0
2020-08-29,746,47791,,0,47791,,0,0,1,,0
2020-08-30,1077,48868,,0,48868,,0,0,1,,0
2020-08-31,721,49589,,0,49589,,0,1,2,,0
2020-09-01,1761,51350,1867,1867,53217,,0,2,4,,0
2020-09-02,1783,53133,3651,5518,58651,,0,1,5,,0
2020-09-03,1497,54630,1308,6826,61456,,0,1,6,,0
2020-09-04,1273,55903,935,7761,63664,,0,0,6,,0
2020-09-05,770,56673,443,8204,64877,,0,2,8,,0
2020-09-06,770,57443,425,8629,66072,,0,0,8,,0
2020-09-07,1079,58522,451,9080,67602,,0,0,8,,0
2020-09-08,801,59323,418,9498,68821,,0,3,11,,0
2020-09-09,1133,60456,571,10069,70525,,0,0,11,,0
2020-09-10,13616,74072,5277,15346,89418,,0,1,12,,0
2020-09-11,5139,79211,1878,17224,96435,,0,4,16,,0
2020-09-12,5070,84281,1460,18684,102965,,0,1,17,,0
2020-09-13,4271,88552,1259,19943,108495,,0,3,20,,0
2020-09-14,2745,91297,791,20734,112031,,0,4,24,,0
2020-09-15,1675,92972,434,21168,114140,,0,4,28,,0
2020-09-16,2088,95060,584,21752,116812,,0,4,32,,0
2020-09-17,1102,96162,379,22131,118293,,0,5,37,,0
2020-09-18,829,96991,280,22411,119402,,0,3,40,,0
2020-09-19,574,97565,204,22615,120180,,0,1,41,,0
2020-09-20,592,98157,209,22824,120981,,0,5,46,,0
2020-09-21,522,98679,167,22991,121670,,0,2,48,,0
2020-09-22,672,99351,245,23236,122587,,0,2,50,,0
2020-09-23,502,99853,198,23434,123287,,0,8,58,,0
2020-09-24,648,100501,183,23617,124118,,0,3,61,,0
2020-09-25,953,101454,277,23894,125348,14,14,7,68,,0
2020-09-26,649,102103,212,24106,126209,4,18,2,70,,0
2020-09-27,535,102638,184,24290,126928,14,32,7,77,,0
2020-09-28,614,103252,202,24492,127744,9,41,3,80,,0
2020-09-29,466,103718,157,24649,128367,12,53,5,85,,0
2020-09-30,676,104394,223,24872,129266,14,67,11,96,,0
2020-10-01,513,104907,190,25062,129969,22,89,17,113,,0
2020-10-02,649,105556,214,25276,130832,23,112,10,123,,0
2020-10-03,445,106001,153,25429,131430,37,149,18,141,,0
2020-10-04,441,106442,118,25547,131989,11,160,10,151,,0
2020-10-05,461,106903,111,25658,132561,14,174,5,156,,0
2020-10-06,1308,108211,360,26018,134229,16,190,7,163,,0
2020-10-07,1729,109940,512,26530,136470,21,211,11,174,,0
2020-10-08,2059,111999,515,27045,139044,41,252,16,190,,0
2020-10-09,2315,114314,769,27814,142128,61,313,27,217,,0
2020-10-10,1029,115343,293,28107,143450,41,354,25,242,,0
2020-10-11,3453,118796,1118,29225,148021,38,392,14,256,,0
2020-10-12,1804,120600,554,29779,150379,44,436,20,276,,0
2020-10-13,2761,123361,755,30534,153895,50,486,26,302,,0
2020-10-14,5777,129138,1651,32185,161323,60,546,30,332,,0
2020-10-15,2941,132079,915,33100,165179,79,625,47,379,,0
2020-10-16,2521,134600,695,33795,168395,74,699,41,420,,0
2020-10-17,1796,136396,440,34235,170631,146,845,79,499,,0
2020-10-18,3187,139583,864,35099,174682,172,1017,71,570,,0
2020-10-19,11642,151225,3775,38874,190099,152,1169,62,632,,0
2020-10-20,3212,154437,919,39793,194230,169,1338,104,736,,0
2020-10-21,3311,157748,786,40579,198327,187,1525,103,839,,0
2020-10-22,3264,161012,765,41344,202356,221,1746,109,948,,0
2020-10-23,1771,162783,465,41809,204592,223,1969,111,1059,,0
2020-10-24,1534,164317,421,42230,206547,182,2151,118,1177,,0
2020-10-25,1440,165757,345,42575,208332,166,2317,102,1279,,0
2020-10-26,1372,167129,399,42974,210103,177,2494,102,1381,,0
2020-10-27,1241,168370,339,43313,211683,203,2697,107,1488,,0
2020-10-28,1444,169814,327,43640,213454,247,2944,133,1621,,0
2020-10-29,1877,171691,432,44072,215763,211,3155,126,1747,,0
2020-10-30,925,172616,265,44337,216953,172,3327,101,1848,,0
2020-10-31,511,173127,147,44484,217611,274,3601,173,2021,,0
2020-11-01,557,173684,168,44652,218336,184,3785,101,2122,,0
2020-11-02,704,174388,158,44810,219198,209,3994,118,2240,,0
2020-11-03,487,174875,100,44910,219785,209,4203,97,2337,,0
2020-11-04,412,175287,97,45007,220294,220,4423,116,2453,,0
2020-11-05,333,175620,83,45090,220710,186,4609,105,2558,,0
2020-11-06,286,175906,72,45162,221068,173,4782,99,2657,,0
2020-11-07,221,176127,62,45224,221351,172,4954,99,2756,,0
2020-11-08,171,176298,54,45278,221576,202,5156,108,2864,,0
2020-11-09,238,176536,55,45333,221869,77,5233,37,2901,,0
2020-11-10,266,176802,75,45408,222210,220,5453,112,3013,,0
2020-11-11,390,177192,92,45500,222692,245,5698,132,3145,,0
2020-11-12,298,177490,89,45589,223079,182,5880,101,3246,,0
2020-11-13,339,177829,97,45686,223515,179,6059,94,3340,,0
2020-11-14,240,178069,62,45748,223817,182,6241,88,3428,,0
2020-11-15,254,178323,72,45820,224143,96,6337,52,3480,,0
2020-11-16,233,178556,48,45868,224424,109,6446,62,3542,,0
2020-11-17,258,178814,78,45946,224760,164,6610,115,3657,,0
2020-11-18,252,179066,73,46019,225085,165,6775,100,3757,,0
2020-11-19,261,179327,66,46085,225412,172,6947,116,3873,,0
2020-11-20,320,179647,83,46168,225815,146,7093,83,3956,,0
2020-11-21,216,179863,46,46214,226077,126,7219,89,4045,,0
2020-11-22,230,180093,62,46276,226369,79,7298,49,4094,,0
2020-11-23,192,180285,50,46326,226611,79,7377,41,4135,,0
2020-11-24,180,180465,25,46351,226816,141,7518,105,4240,,0
2020-11-25,174,180639,53,46404,227043,188,7706,122,4362,,0
2020-11-26,202,180841,61,46465,227306,132,7838,85,4447,,0
2020-11-27,178,181019,18,46483,227502,140,7978,98,4545,,0
2020-11-28,118,181137,50,46533,227670,86,8064,56,4601,,0
2020-11-29,168,181305,46,46579,227884,68,8132,43,4644,,0
2020-11-30,153,181458,43,46622,228080,68,8200,41,4685,,0
2020-12-01,155,181613,34,46656,228269,147,8347,102,4787,,0
2020-12-02,140,181753,52,46708,228461,150,8497,99,4886,,0
2020-12-03,112,181865,38,46746,228611,129,8626,92,4978,,0
2020-12-04,115,181980,41,46787,228767,112,8738,76,5054,,0
2020-12-05,97,182077,41,46828,228905,111,8849,79,5133,,0
2020-12-06,133,182210,29,46857,229067,87,8936,61,5194,,0
2020-12-07,126,182336,44,46901,229237,64,9000,35,5229,,0
2020-12-08,131,182467,54,46955,229422,123,9123,76,5305,,0
2020-12-09,123,182590,46,47001,229591,155,9278,95,5400,,0
2020-12-10,112,182702,34,47035,229737,103,9381,63,5463,,0
2020-12-11,124,182826,51,47086,229912,90,9471,61,5524,,0
2020-12-12,123,182949,53,47139,230088,88,9559,70,5594,,0
2020-12-13,10322,193271,2196,49335,242606,81,9640,59,5653,,0
2020-12-14,41506,234777,8705,58040,292817,488,10128,104,5757,,0
2020-12-15,23865,258642,5173,63213,321855,777,10905,124,5881,,0
2020-12-16,13682,272324,3056,66269,338593,938,11843,183,6064,,0
2020-12-17,10261,282585,2327,68596,351181,866,12709,116,6180,,0
2020-12-18,10666,293251,2421,71017,364268,1004,13713,142,6322,,0
2020-12-19,9985,303236,2675,73692,376928,752,14465,107,6429,,0
2020-12-20,6501,309737,1548,75240,384977,316,14781,48,6477,,0
2020-12-21,4912,314649,1006,76246,390895,754,15535,99,6576,,0
2020-12-22,4134,318783,950,77196,395979,1645,17180,190,6766,,0
2020-12-23,2949,321732,801,77997,399729,1633,18813,211,6977,,0
2020-12-24,1379,323111,409,78406,401517,1462,20275,143,7120,,0
2020-12-25,1061,324172,294,78700,402872,328,20603,52,7172,,0
2020-12-26,824,324996,288,78988,403984,399,21002,66,7238,,0
2020-12-27,654,325650,208,79196,404846,413,21415,71,7309,,0
2020-12-28,488,326138,129,79325,405463,1321,22736,154,7463,,0
2020-12-29,498,326636,115,79440,406076,1855,24591,221,7684,,0
2020-12-30,468,327104,140,79580,406684,1973,26564,233,7917,,0
2020-12-31,366,327470,107,79687,407157,1521,28085,191,8108,,0
2021-01-01,300,327770,64,79751,407521,309,28394,34,8142,,0
2021-01-02,333,328103,95,79846,407949,474,28868,65,8207,,0
2021-01-03,337,328440,98,79944,408384,487,29355,70,8277,,0
2021-01-04,301,328741,90,80034,408775,1601,30956,202,8479,,0
2021-01-05,284,329025,79,80113,409138,2730,33686,274,8753,,0
2021-01-06,272,329297,66,80179,409476,2163,35849,237,8990,,0
2021-01-07,239,329536,68,80247,409783,1631,37480,168,9158,,0
2021-01-08,283,329819,68,80315,410134,1558,39038,169,9327,,0
2021-01-09,235,330054,68,80383,410437,579,39617,75,9402,,0
2021-01-10,212,330266,57,80440,410706,290,39907,42,9444,,0
2021-01-11,201,330467,46,80486,410953,1193,41100,105,9549,,0
2021-01-12,169,330636,46,80532,411168,1732,42832,162,9711,,0
2021-01-13,183,330819,39,80571,411390,1390,44222,150,9861,,0
2021-01-14,251,331070,86,80657,411727,1181,45403,117,9978,,0
2021-01-15,236,331306,62,80719,412025,1225,46628,94,10072,,0
2021-01-16,189,331495,62,80781,412276,542,47170,64,10136,,0
2021-01-17,171,331666,44,80825,412491,252,47422,37,10173,,0
2021-01-18,151,331817,34,80859,412676,1193,48615,114,10287,,0
2021-01-19,141,331958,32,80891,412849,1389,50004,136,10423,,0
2021-01-20,138,332096,38,80929,413025,1162,51166,115,10538,,0
2021-01-21,123,332219,38,80967,413186,1076,52242,109,10647,,0
2021-01-22,240,332459,76,81043,413502,1156,53398,121,10768,,0
2021-01-23,142,332601,33,81076,413677,515,53913,53,10821,,0
2021-01-24,142,332743,39,81115,413858,237,54150,42,10863,,0
2021-01-25,165,332908,37,81152,414060,1177,55327,117,10980,,0
2021-01-26,134,333042,37,81189,414231,1539,56866,161,11141,,0
2021-01-27,114,333156,34,81223,414379,1263,58129,115,11256,,0
2021-01-28,99,333255,24,81247,414502,1095,59224,125,11381,,0
2021-01-29,118,333373,34,81281,414654,983,60207,104,11485,,0
2021-01-30,211,333584,59,81340,414924,544,60751,51,11536,,0
2021-01-31,83,333667,25,81365,415032,299,61050,36,11572,,0
2021-02-01,102,333769,24,81389,415158,1179,62229,106,11678,,0
2021-02-02,92,333861,19,81408,415269,1297,63526,119,11797,,0
2021-02-03,88,333949,17,81425,415374,1070,64596,87,11884,,0
2021-02-04,93,334042,23,81448,415490,804,65400,69,11953,,0
2021-02-05,78,334120,20,81468,415588,726,66126,64,12017,,0
2021-02-06,57,334177,20,81488,415665,567,66693,58,12075,,0
2021-02-07,61,334238,23,81511,415749,246,66939,29,12104,,0
2021-02-08,61,334299,9,81520,415819,291,67230,29,12133,,0
2021-02-09,77,334376,21,81541,415917,1235,68465,77,12210,,0
2021-02-10,64,334440,24,81565,416005,1264,69729,806,13016,,0
2021-02-11,61,334501,17,81582,416083,1047,70776,1076,14092,,0
2021-02-12,139,334640,37,81619,416259,951,71727,954,15046,,0
2021-02-13,64,334704,22,81641,416345,625,72352,957,16003,,0
2021-02-14,44,334748,23,81664,416412,333,72685,681,16684,,0
2021-02-15,43,334791,18,81682,416473,657,73342,1010,17694,,0
2021-02-16,50,334841,19,81701,416542,974,74316,2059,19753,,0
2021-02-17,42,334883,15,81716,416599,769,75085,2095,21848,,0
2021-02-18,55,334938,17,81733,416671,717,75802,2071,23919,,0
2021-02-19,55,334993,9,81742,416735,850,76652,2220,26139,,0
2021-02-20,48,335041,13,81755,416796,407,77059,1943,28082,,0
2021-02-21,32,335073,16,81771,416844,234,77293,1241,29323,,0
2021-02-22,58,335131,15,81786,416917,702,77995,1424,30747,,0
2021-02-23,50,335181,11,81797,416978,969,78964,2150,32897,,0
2021-02-24,43,335224,20,81817,417041,744,79708,2154,35051,,0
2021-02-25,38,335262,18,81835,417097,834,80542,2179,37230,,0
2021-02-26,36,335298,14,81849,417147,849,81391,2240,39470,,0
2021-02-27,32,335330,8,81857,417187,422,81813,1950,41420,,0
2021-02-28,55,335385,13,81870,417255,213,82026,1217,42637,,0
2021-03-01,42,335427,13,81883,417310,589,82615,1397,44034,,0
2021-03-02,52,335479,10,81893,417372,1028,83643,2298,46332,,0
2021-03-03,42,335521,19,81912,417433,930,84573,2330,48662,,0
2021-03-04,54,335575,21,81933,417508,758,85331,2028,50690,,0
2021-03-05,47,335622,17,81950,417572,786,86117,2270,52960,,0
2021-03-06,43,335665,11,81961,417626,382,86499,2017,54977,,0
2021-03-07,36,335701,7,81968,417669,180,86679,1275,56252,,0
2021-03-08,31,335732,6,81974,417706,633,87312,1494,57746,,0
2021-03-09,53,335785,10,81984,417769,824,88136,2691,60437,,0
2021-03-10,43,335828,10,81994,417822,762,88898,2769,63206,,0
2021-03-11,45,335873,14,82008,417881,664,89562,2771,65977,,0
2021-03-12,38,335911,7,82015,417926,549,90111,3145,69122,,0
2021-03-13,36,335947,15,82030,417977,692,90803,2746,71868,,0
2021-03-14,27,335974,10,82040,418014,183,90986,1639,73507,,0
2021-03-15,47,336021,14,82054,418075,772,91758,2062,75569,,0
2021-03-16,37,336058,16,82070,418128,717,92475,3518,79087,,0
2021-03-17,34,336092,15,82085,418177,981,93456,3667,82754,,0
2021-03-18,50,336142,7,82092,418234,820,94276,3452,86206,,0
2021-03-19,40,336182,9,82101,418283,915,95191,3863,90069,,0
2021-03-20,31,336213,7,82108,418321,480,95671,3502,93571,,0
2021-03-21,34,336247,14,82122,418369,249,95920,2112,95683,,0
2021-03-22,30,336277,10,82132,418409,777,96697,2532,98215,,0
2021-03-23,60,336337,9,82141,418478,1201,97898,4636,102851,,0
2021-03-24,58,336395,14,82155,418550,1061,98959,4904,107755,,0
2021-03-25,47,336442,13,82168,418610,931,99890,4721,112476,,0
2021-03-26,35,336477,14,82182,418659,1090,100980,4747,117223,,0
2021-03-27,35,336512,9,82191,418703,654,101634,4143,121366,,0
2021-03-28,44,336556,19,82210,418766,277,101911,2534,123900,,0
2021-03-29,46,336602,8,82218,418820,932,102843,3010,126910,,0
2021-03-30,50,336652,10,82228,418880,1368,104211,4773,131683,,0
2021-03-31,55,336707,9,82237,418944,1228,105439,5085,136768,,0
2021-04-01,49,336756,10,82247,419003,1062,106501,4702,141470,,0
2021-04-02,50,336806,22,82269,419075,1106,107607,4113,145583,,0
2021-04-03,29,336835,9,82278,419113,694,108301,2854,148437,,0
2021-04-04,34,336869,9,82287,419156,263,108564,2329,150766,,0
2021-04-05,43,336912,14,82301,419213,235,108799,2168,152934,,0
2021-04-06,47,336959,6,82307,419266,1028,109827,3067,156001,,0
2021-04-07,39,336998,10,82317,419315,1370,111197,5113,161114,103,103
2021-04-08,38,337036,9,82326,419362,1136,112333,5121,166235,93,196
2021-04-09,41,337077,19,82345,419422,1128,113461,5241,171476,85,281
2021-04-10,34,337111,6,82351,419462,556,114017,4070,175546,42,323
2021-04-11,31,337142,9,82360,419502,262,114279,2497,178043,16,339
2021-04-12,46,337188,1,82361,419549,896,115175,2898,180941,60,399
2021-04-13,30,337218,8,82369,419587,1130,116305,5233,186174,80,479
2021-04-14,87,337305,10,82379,419684,781,117086,5130,191304,51,530
2021-04-15,102,337407,19,82398,419805,734,117820,4529,195833,36,566
2021-04-16,86,337493,12,82410,419903,660,118480,4463,200296,32,598
2021-04-17,46,337539,10,82420,419959,418,118898,3999,204295,40,638
2021-04-18,49,337588,7,82427,420015,185,119083,2354,206649,14,652
2021-04-19,45,337633,12,82439,420072,605,119688,3218,209867,34,686
2021-04-20,60,337693,9,82448,420141,876,120564,5349,215216,48,734
2021-04-21,36,337729,5,82453,420182,659,121223,5588,220804,37,771
2021-04-22,32,337761,10,82463,420224,755,121978,4623,225427,49,820
2021-04-23,43,337804,6,82469,420273,743,122721,4662,230089,44,864
2021-04-24,31,337835,5,82474,420309,386,123107,3891,233980,26,890
2021-04-25,32,337867,4,82478,420345,155,123262,2304,236284,17,907
2021-04-26,48,337915,7,82485,420400,680,123942,2496,238780,43,950
2021-04-27,35,337950,12,82497,420447,376,124318,4384,243164,26,976
2021-04-28,42,337992,9,82506,420498,796,125114,4409,247573,42,1018
2021-04-29,33,338025,8,82514,420539,878,125992,3297,250870,68,1086
2021-04-30,26,338051,10,82524,420575,906,126898,3409,254279,70,1156
2021-05-01,20,338071,3,82527,420598,307,127205,2831,257110,24,1180
2021-05-02,44,338115,8,82535,420650,174,127379,1768,258878,15,1195
2021-05-03,47,338162,8,82543,420705,755,128134,2424,261302,49,1244
2021-05-04,45,338207,4,82547,420754,861,128995,4176,265478,59,1303
2021-05-05,35,338242,14,82561,420803,737,129732,3529,269007,35,1338
2021-05-06,67,338309,11,82572,420881,574,130306,3091,272098,20,1358
2021-05-07,78,338387,8,82580,420967,601,130907,3145,275243,34,1392
2021-05-08,34,338421,7,82587,421008,283,131190,2764,278007,13,1405
2021-05-09,45,338466,3,82590,421056,118,131308,1605,279612,6,1411
2021-05-10,50,338516,9,82599,421115,439,131747,1936,281548,24,1435
2021-05-11,47,338563,7,82606,421169,640,132387,3153,284701,25,1460
2021-05-12,42,338605,9,82615,421220,464,132851,2700,287401,39,1499
2021-05-13,62,338667,15,82630,421297,412,133263,2142,289543,23,1522
2021-05-14,73,338740,20,82650,421390,466,133729,1852,291395,30,1552
2021-05-15,36,338776,14,82664,421440,238,133967,1807,293202,21,1573
2021-05-16,46,338822,10,82674,421496,94,134061,997,294199,5,1578
2021-05-17,48,338870,12,82686,421556,445,134506,1189,295388,28,1606
2021-05-18,53,338923,10,82696,421619,507,135013,2271,297659,34,1640
2021-05-19,50,338973,10,82706,421679,323,135336,2061,299720,10,1650
2021-05-20,37,339010,8,82714,421724,275,135611,1821,301541,18,1668
2021-05-21,51,339061,22,82736,421797,341,135952,1817,303358,11,1679
2021-05-22,33,339094,10,82746,421840,167,136119,1423,304781,9,1688
2021-05-23,47,339141,9,82755,421896,73,136192,829,305610,,1688
2021-05-24,40,339181,11,82766,421947,282,136474,662,306272,16,1704
2021-05-25,42,339223,8,82774,421997,340,136814,1027,307299,20,1724
2021-05-26,48,339271,10,82784,422055,351,137165,1504,308803,29,1753
2021-05-27,38,339309,1,82785,422094,272,137437,1385,310188,15,1768
2021-05-28,21,339330,6,82791,422121,321,137758,1245,311433,23,1791
2021-05-29,29,339359,5,82796,422155,118,137876,1050,312483,9,1800
2021-05-30,26,339385,5,82801,422186,75,137951,713,313196,2,1802
2021-05-31,43,339428,8,82809,422237,267,138218,350,313546,11,1813
2021-06-01,50,339478,6,82815,422293,357,138575,21,313567,18,1831
2021-06-02,55,339533,12,82827,422360,242,138817,85,313652,21,1852
2021-06-03,64,339597,8,82835,422432,244,139061,12,313664,15,1867
2021-06-04,54,339651,8,82843,422494,212,139273,586,314250,11,1878
2021-06-05,42,339693,2,82845,422538,163,139436,704,314954,9,1887
2021-06-06,35,339728,13,82858,422586,47,139483,442,315396,3,1890
2021-06-07,52,339780,5,82863,422643,200,139683,487,315883,15,1905
2021-06-08,59,339839,14,82877,422716,244,139927,662,316545,13,1918
2021-06-09,59,339898,5,82882,422780,183,140110,561,317106,11,1929
2021-06-10,52,339950,5,82887,422837,110,140220,539,317645,7,1936
2021-06-11,95,340045,11,82898,422943,108,140328,503,318148,5,1941
2021-06-12,54,340099,12,82910,423009,80,140408,442,318590,2,1943
2021-06-13,40,340139,4,82914,423053,24,140432,336,318926,1,1944
2021-06-14,38,340177,11,82925,423102,95,140527,335,319261,1,1945
2021-06-15,69,340246,15,82940,423186,90,140617,432,319693,2,1947
2021-06-16,54,340300,10,82950,423250,73,140690,456,320149,2,1949
2021-06-17,52,340352,6,82956,423308,72,140762,348,320497,1,1950
2021-06-18,62,340414,9,82965,423379,72,140834,323,320820,1,1951
2021-06-19,46,340460,9,82974,423434,16,140850,283,321103,,1951
2021-06-20,35,340495,4,82978,423473,12,140862,228,321331,1,1952
2021-06-21,55,340550,11,82989,423539,52,140914,275,321606,1,1953
2021-06-22,67,340617,8,82997,423614,46,140960,297,321903,,1953
2021-06-23,71,340688,7,83004,423692,31,140991,303,322206,1,1954
2021-06-24,79,340767,11,83015,423782,34,141025,288,322494,1,1955
2021-06-25,38,340805,5,83020,423825,11,141036,237,322731,,1955
2021-06-26,39,340844,10,83030,423874,12,141048,235,322966,1,1956
2021-06-27,33,340877,9,83039,423916,3,141051,219,323185,,1956
2021-06-28,51,340928,12,83051,423979,31,141082,228,323413,,1956
2021-06-29,54,340982,8,83059,424041,38,141120,302,323715,1,1957
2021-06-30,58,341040,9,83068,424108,21,141141,288,324003,2,1959
2021-07-01,161,341201,9,83077,424278,19,141160,324,324327,,1959
2021-07-02,103,341304,21,83098,424402,26,141186,392,324719,3,1962
2021-07-03,64,341368,10,83108,424476,7,141193,419,325138,,1962
2021-07-04,61,341429,7,83115,424544,6,141199,417,325555,,1962
2021-07-05,110,341539,8,83123,424662,43,141242,530,326085,1,1963
2021-07-06,188,341727,16,83139,424866,66,141308,778,326863,3,1966
2021-07-07,152,341879,11,83150,425029,69,141377,1025,327888,1,1967
2021-07-08,143,342022,18,83168,425190,76,141453,1331,329219,4,1971
2021-07-09,145,342167,10,83178,425345,73,141526,1623,330842,2,1973
2021-07-10,113,342280,8,83186,425466,20,141546,1728,332570,1,1974
2021-07-11,121,342401,5,83191,425592,8,141554,2105,334675,,1974
2021-07-12,127,342528,17,83208,425736,71,141625,2245,336920,2,1976
2021-07-13,140,342668,13,83221,425889,70,141695,2275,339195,2,1978
2021-07-14,133,342801,12,83233,426034,47,141742,2436,341631,,1978
2021-07-15,149,342950,21,83254,426204,60,141802,2593,344224,3,1981
2021-07-16,169,343119,14,83268,426387,58,141860,2247,346471,1,1982
2021-07-17,99,343218,15,83283,426501,22,141882,2011,348482,,1982
2021-07-18,84,343302,8,83291,426593,7,141889,1763,350245,1,1983
2021-07-19,51,343353,14,83305,426658,73,141962,1623,351868,3,1986
2021-07-20,85,343438,12,83317,426755,99,142061,1655,353523,3,1989
2021-07-21,89,343527,17,83334,426861,66,142127,1524,355047,1,1990
2021-07-22,115,343642,11,83345,426987,51,142178,1437,356484,,1990
2021-07-23,174,343816,17,83362,427178,75,142253,1294,357778,3,1993
2021-07-24,111,343927,11,83373,427300,31,142284,1028,358806,2,1995
2021-07-25,113,344040,8,83381,427421,17,142301,747,359553,1,1996
2021-07-26,165,344205,20,83401,427606,93,142394,816,360369,1,1997
2021-07-27,128,344333,11,83412,427745,69,142463,1020,361389,6,2003
2021-07-28,107,344440,9,83421,427861,100,142563,1015,362404,,2003
2021-07-29,80,344520,11,83432,427952,101,142664,851,363255,3,2006
2021-07-30,156,344676,14,83446,428122,119,142783,801,364056,3,2009
2021-07-31,111,344787,6,83452,428239,51,142834,787,364843,,2009
2021-08-01,110,344897,16,83468,428365,29,142863,503,365346,3,2012
2021-08-02,134,345031,24,83492,428523,159,143022,494,365840,4,2016
2021-08-03,106,345137,7,83499,428636,128,143150,811,366651,2,2018
2021-08-04,81,345218,12,83511,428729,122,143272,788,367439,3,2021
2021-08-05,125,345343,6,83517,428860,127,143399,770,368209,2,2023
2021-08-06,146,345489,28,83545,429034,119,143518,804,369013,4,2027
2021-08-07,75,345564,9,83554,429118,61,143579,611,369624,5,2032
2021-08-08,101,345665,20,83574,429239,48,143627,468,370092,2,2034
2021-08-09,69,345734,22,83596,429330,179,143806,530,370622,8,2042
2021-08-10,96,345830,16,83612,429442,217,144023,810,371432,9,2051
2021-08-11,76,345906,10,83622,429528,220,144243,777,372209,8,2059
2021-08-12,118,346024,15,83637,429661,176,144419,767,372976,4,2063
2021-08-13,114,346138,10,83647,429785,224,144643,809,373785,14,2077
2021-08-14,76,346214,14,83661,429875,86,144729,660,374445,2,2079
2021-08-15,76,346290,13,83674,429964,43,144772,438,374883,3,2082
2021-08-16,75,346365,17,83691,430056,278,145050,623,375506,13,2095
2021-08-17,92,346457,13,83704,430161,321,145371,992,376498,15,2110
2021-08-18,84,346541,21,83725,430266,351,145722,878,377376,10,2120
2021-08-19,75,346616,16,83741,430357,298,146020,875,378251,14,2134
2021-08-20,106,346722,20,83761,430483,331,146351,848,379099,12,2146
2021-08-21,80,346802,10,83771,430573,215,146566,772,379871,11,2157
2021-08-22,89,346891,14,83785,430676,93,146659,438,380309,4,2161
2021-08-23,98,346989,13,83798,430787,396,147055,668,380977,14,2175
2021-08-24,90,347079,17,83815,430894,472,147527,1183,382160,23,2198
2021-08-25,79,347158,14,83829,430987,467,147994,1166,383326,15,2213
2021-08-26,99,347257,17,83846,431103,479,148473,1066,384392,17,2230
2021-08-27,119,347376,12,83858,431234,486,148959,1114,385506,25,2255
2021-08-28,108,347484,20,83878,431362,235,149194,1023,386529,13,2268
2021-08-29,125,347609,8,83886,431495,117,149311,519,387048,2,2270
2021-08-30,91,347700,10,83896,431596,468,149779,733,387781,15,2285
2021-08-31,119,347819,15,83911,431730,700,150479,1489,389270,20,2305
2021-09-01,85,347904,11,83922,431826,599,151078,1384,390654,18,2323
2021-09-02,101,348005,8,83930,431935,552,151630,1162,391816,23,2346
2021-09-03,73,348078,17,83947,432025,657,152287,1528,393344,23,2369
2021-09-04,82,348160,10,83957,432117,289,152576,1146,394490,8,2377
2021-09-05,102,348262,11,83968,432230,211,152787,644,395134,13,2390
2021-09-06,213,348475,17,83985,432460,754,153541,726,395860,21,2411
2021-09-07,225,348700,15,84000,432700,955,154496,1704,397564,38,2449
2021-09-08,200,348900,27,84027,432927,914,155410,1405,398969,25,2474
2021-09-09,220,349120,13,84040,433160,931,156341,1289,400258,40,2514
2021-09-10,228,349348,20,84060,433408,914,157255,1292,401550,24,2538
2021-09-11,176,349524,16,84076,433600,505,157760,1096,402646,18,2556
2021-09-12,263,349787,16,84092,433879,259,158019,568,403214,12,2568
2021-09-13,527,350314,32,84124,434438,1171,159190,709,403923,31,2599
2021-09-14,889,351203,35,84159,435362,1221,160411,1480,405403,40,2639
2021-09-15,1003,352206,44,84203,436409,1190,161601,1218,406621,44,2683
2021-09-16,676,352882,26,84229,437111,594,162195,1034,407655,20,2703
2021-09-17,546,353428,48,84277,437705,1472,163667,1093,408748,51,2754
2021-09-18,344,353772,32,84309,438081,514,164181,821,409569,24,2778
2021-09-19,291,354063,25,84334,438397,292,164473,360,409929,15,2793
2021-09-20,325,354388,26,84360,438748,1090,165563,807,410736,31,2824
2021-09-21,300,354688,18,84378,439066,1111,166674,1220,411956,36,2860
2021-09-22,287,354975,20,84398,439373,933,167607,1083,413039,35,2895
2021-09-23,221,355196,14,84412,439608,816,168423,1001,414040,16,2911
2021-09-24,263,355459,18,84430,439889,911,169334,1080,415120,26,2937
2021-09-25,188,355647,15,84445,440092,421,169755,830,415950,23,2960
2021-09-26,160,355807,16,84461,440268,259,170014,493,416443,12,2972
2021-09-27,243,356050,25,84486,440536,795,170809,676,417119,26,2998
2021-09-28,192,356242,19,84505,440747,1200,172009,1369,418488,44,3042
2021-09-29,169,356411,20,84525,440936,913,172922,1167,419655,29,3071
2021-09-30,154,356565,23,84548,441113,898,173820,1048,420703,34,3105
2021-10-01,161,356726,29,84577,441303,825,174645,1056,421759,31,3136
2021-10-02,129,356855,13,84590,441445,464,175109,848,422607,13,3149
2021-10-03,139,356994,7,84597,441591,236,175345,482,423089,9,3158
2021-10-04,154,357148,14,84611,441759,881,176226,670,423759,33,3191
2021-10-05,138,357286,14,84625,441911,1069,177295,1399,425158,35,3226
2021-10-06,148,357434,16,84641,442075,879,178174,1235,426393,34,3260
2021-10-07,173,357607,19,84660,442267,721,178895,1135,427528,20,3280
2021-10-08,132,357739,18,84678,442417,807,179702,1339,428867,22,3302
2021-10-09,109,357848,5,84683,442531,431,180133,1149,430016,21,3323
2021-10-10,95,357943,14,84697,442640,178,180311,663,430679,10,3333
2021-10-11,121,358064,18,84715,442779,875,181186,846,431525,26,3359
2021-10-12,114,358178,13,84728,442906,1122,182308,1771,433296,44,3403
2021-10-13,118,358296,14,84742,443038,985,183293,1670,434966,26,3429
2021-10-14,128,358424,14,84756,443180,998,184291,1645,436611,42,3471
2021-10-15,127,358551,22,84778,443329,1236,185527,1774,438385,37,3508
2021-10-16,92,358643,10,84788,443431,642,186169,1599,439984,26,3534
2021-10-17,100,358743,12,84800,443543,333,186502,1010,440994,16,3550
2021-10-18,118,358861,11,84811,443672,1523,188025,1359,442353,54,3604
2021-10-19,101,358962,17,84828,443790,1938,189963,2565,444918,78,3682
2021-10-20,156,359118,39,84867,443985,1690,191653,2476,447394,74,3756
2021-10-21,106,359224,16,84883,444107,1752,193405,2503,449897,89,3845
2021-10-22,149,359373,30,84913,444286,1957,195362,2679,452576,83,3928
2021-10-23,125,359498,15,84928,444426,1467,196829,2611,455187,65,3993
2021-10-24,110,359608,9,84937,444545,647,197476,1636,456823,23,4016
2021-10-25,125,359733,21,84958,444691,1981,199457,1957,458780,90,4106
2021-10-26,150,359883,26,84984,444867,2901,202358,3867,462647,124,4230
2021-10-27,147,360030,33,85017,445047,2469,204827,4002,466649,97,4327
2021-10-28,228,360258,42,85059,445317,2289,207116,3660,470309,92,4419
2021-10-29,255,360513,31,85090,445603,2584,209700,3858,474167,97,4516
2021-10-30,148,360661,25,85115,445776,1674,211374,3533,477700,75,4591
2021-10-31,127,360788,24,85139,445927,1035,212409,2102,479802,46,4637
2021-11-01,141,360929,20,85159,446088,1159,213568,2223,482025,32,4669
2021-11-02,189,361118,31,85190,446308,2749,216317,4055,486080,108,4777
2021-11-03,238,361356,30,85220,446576,4195,220512,5852,491932,145,4922
2021-11-04,340,361696,59,85279,446975,3587,224099,5988,497920,130,5052
2021-11-05,324,362020,36,85315,447335,3212,227311,5901,503821,136,5188
2021-11-06,269,362289,34,85349,447638,2273,229584,5485,509306,94,5282
2021-11-07,332,362621,34,85383,448004,1188,230772,3247,512553,53,5335
2021-11-08,442,363063,29,85412,448475,2853,233625,4060,516613,96,5431
2021-11-09,394,363457,35,85447,448904,4087,237712,7646,524259,156,5587
2021-11-10,407,363864,40,85487,449351,3390,241102,8204,532463,116,5703
2021-11-11,364,364228,30,85517,449745,3137,244239,7476,539939,110,5813
2021-11-12,329,364557,38,85555,450112,3254,247493,8048,547987,122,5935
2021-11-13,232,364789,27,85582,450371,2303,249796,7063,555050,96,6031
2021-11-14,240,365029,22,85604,450633,1754,251550,3898,558948,71,6102
2021-11-15,365,365394,33,85637,451031,3255,254805,6275,565223,125,6227
2021-11-16,310,365704,36,85673,451377,4018,258823,10019,575242,129,6356
2021-11-17,309,366013,29,85702,451715,3334,262157,10560,585802,106,6462
2021-11-18,267,366280,24,85726,452006,3199,265356,9549,595351,109,6571
2021-11-19,265,366545,33,85759,452304,2981,268337,10024,605375,102,6673
2021-11-20,174,366719,19,85778,452497,2146,270483,9886,615261,75,6748
2021-11-21,213,366932,28,85806,452738,1336,271819,5284,620545,39,6787
2021-11-22,243,367175,29,85835,453010,2905,274724,6580,627125,77,6864
2021-11-23,256,367431,29,85864,453295,2987,277711,12056,639181,89,6953
2021-11-24,209,367640,26,85890,453530,2461,280172,11581,650762,86,7039
2021-11-25,257,367897,25,85915,453812,1888,282060,7751,658513,58,7097
2021-11-26,238,368135,17,85932,454067,2031,284091,15934,674447,55,7152
2021-11-27,152,368287,12,85944,454231,1440,285531,10058,684505,39,7191
2021-11-28,169,368456,12,85956,454412,951,286482,5528,690033,34,7225
2021-11-29,221,368677,16,85972,454649,2189,288671,5922,695955,78,7303
2021-11-30,223,368900,13,85985,454885,2117,290788,11977,707932,62,7365
2021-12-01,207,369107,13,85998,455105,1947,292735,11792,719724,45,7410
2021-12-02,226,369333,19,86017,455350,1624,294359,10161,729885,55,7465
2021-12-03,190,369523,14,86031,455554,1757,296116,10789,740674,38,7503
2021-12-04,147,369670,18,86049,455719,1049,297165,8454,749128,29,7532
2021-12-05,126,369796,24,86073,455869,704,297869,3920,753048,25,7557
2021-12-06,172,369968,21,86094,456062,1707,299576,4673,757721,53,7610
2021-12-07,185,370153,20,86114,456267,1754,301330,10442,768163,41,7651
2021-12-08,184,370337,19,86133,456470,1529,302859,9880,778043,38,7689
2021-12-09,150,370487,15,86148,456635,1260,304119,8590,786633,29,7718
2021-12-10,156,370643,11,86159,456802,1353,305472,8606,795239,39,7757
2021-12-11,141,370784,16,86175,456959,810,306282,6629,801868,28,7785
2021-12-12,137,370921,15,86190,457111,641,306923,2912,804780,20,7805
2021-12-13,191,371112,20,86210,457322,1546,308469,4507,809287,35,7840
2021-12-14,157,371269,20,86230,457499,1370,309839,9929,819216,33,7873
2021-12-15,152,371421,19,86249,457670,1216,311055,8567,827783,32,7905
2021-12-16,173,371594,13,86262,457856,1170,312225,7103,834886,29,7934
2021-12-17,157,371751,17,86279,458030,1116,313341,6360,841246,41,7975
2021-12-18,121,371872,14,86293,458165,742,314083,6055,847301,29,8004
2021-12-19,147,372019,12,86305,458324,557,314640,2848,850149,14,8018
2021-12-20,172,372191,17,86322,458513,1396,316036,3684,853833,40,8058
2021-12-21,143,372334,22,86344,458678,1114,317150,9189,863022,32,8090
2021-12-22,178,372512,11,86355,458867,999,318149,7446,870468,24,8114
2021-12-23,184,372696,20,86375,459071,1040,319189,7282,877750,27,8141
2021-12-24,167,372863,12,86387,459250,951,320140,6167,883917,33,8174
2021-12-25,128,372991,13,86400,459391,605,320745,3031,886948,17,8191
2021-12-26,133,373124,12,86412,459536,632,321377,3237,890185,25,8216
2021-12-27,161,373285,18,86430,459715,1071,322448,4698,894883,56,8272
2021-12-28,144,373429,15,86445,459874,1591,324039,9757,904640,56,8328
2021-12-29,143,373572,17,86462,460034,1457,325496,8756,913396,43,8371
2021-12-30,149,373721,14,86476,460197,1677,327173,9973,923369,79,8450
2021-12-31,85,373806,11,86487,460293,1568,328741,8368,931737,72,8522
2022-01-01,84,373890,10,86497,460387,757,329498,312,932049,37,8559
2022-01-02,113,374003,20,86517,460520,876,330374,4433,936482,31,8590
2022-01-03,130,374133,33,86550,460683,2942,333316,7292,943774,97,8687
2022-01-04,164,374297,43,86593,460890,3422,336738,15898,959672,123,8810
2022-01-05,209,374506,33,86626,461132,3554,340292,17387,977059,117,8927
2022-01-06,166,374672,40,86666,461338,3756,344048,13636,990695,155,9082
2022-01-07,144,374816,38,86704,461520,3894,347942,13227,1003922,120,9202
2022-01-08,127,374943,24,86728,461671,3346,351288,1255,1005177,124,9326
2022-01-09,156,375099,26,86754,461853,2454,353742,7958,1013135,104,9430
2022-01-10,160,375259,36,86790,462049,4169,357911,11050,1024185,136,9566
2022-01-11,231,375490,40,86830,462320,6809,364720,22126,1046311,184,9750
2022-01-12,205,375695,48,86878,462573,6305,371025,20476,1066787,208,9958
2022-01-13,232,375927,36,86914,462841,6451,377476,19070,1085857,224,10182
2022-01-14,168,376095,42,86956,463051,5967,383443,21351,1107208,197,10379
2022-01-15,146,376241,34,86990,463231,6055,389498,18686,1125894,218,10597
2022-01-16,179,376420,37,87027,463447,4728,394226,10875,1136769,181,10778
2022-01-17,218,376638,43,87070,463708,6007,400233,15264,1152033,212,10990
2022-01-18,246,376884,60,87130,464014,10359,410592,29674,1181707,332,11322
2022-01-19,244,377128,45,87175,464303,7826,418418,30342,1212049,245,11567
2022-01-20,225,377353,60,87235,464588,9730,428148,31237,1243286,332,11899
2022-01-21,244,377597,58,87293,464890,9033,437181,32285,1275571,286,12185
2022-01-22,251,377848,80,87373,465221,11953,449134,28345,1303916,311,12496
2022-01-23,206,378054,41,87414,465468,8699,457833,1587,1305503,299,12795
2022-01-24,239,378293,54,87468,465761,9638,467471,21819,1327322,257,13052
2022-01-25,285,378578,78,87546,466124,13763,481234,38778,1366100,407,13459
2022-01-26,248,378826,64,87610,466436,10790,492024,39375,1405475,286,13745
2022-01-27,275,379101,59,87669,466770,13504,505528,3319,1408794,398,14143
2022-01-28,271,379372,71,87740,467112,10955,516483,34902,1443696,331,14474
2022-01-29,210,379582,45,87785,467367,12479,528962,2885,1446581,353,14827
2022-01-30,194,379776,41,87826,467602,8421,537383,19622,1466203,279,15106
2022-01-31,319,380095,52,87878,467973,8218,545601,22009,1488212,268,15374
2022-02-01,386,380481,61,87939,468420,16252,561853,41061,1529273,457,15831
2022-02-02,305,380786,72,88011,468797,13506,575359,42379,1571652,374,16205
2022-02-03,255,381041,48,88059,469100,10898,586257,37888,1609540,271,16476
2022-02-04,269,381310,48,88107,469417,10801,597058,3981,1613521,284,16760
2022-02-05,152,381462,20,88127,469589,7178,604236,30002,1643523,190,16950
2022-02-06,135,381597,21,88148,469745,5412,609648,2510,1646033,137,17087
2022-02-07,180,381777,28,88176,469953,10380,620028,21452,1667485,251,17338
2022-02-08,140,381917,24,88200,470117,5588,625616,46917,1714402,159,17497
2022-02-09,299,382216,67,88267,470483,10832,636448,59234,1773636,263,17760
2022-02-10,248,382464,53,88320,470784,7600,644048,42518,1816154,170,17930
2022-02-11,161,382625,30,88350,470975,5068,649116,1740,1817894,117,18047
2022-02-12,165,382790,33,88383,471173,5518,654634,30296,1848190,129,18176
2022-02-13,157,382947,33,88416,471363,3894,658528,17637,1865827,98,18274
2022-02-14,203,383150,26,88442,471592,4388,662916,631,1866458,108,18382
2022-02-15,187,383337,34,88476,471813,5874,668790,46291,1912749,150,18532
2022-02-16,136,383473,26,88502,471975,4093,672883,40721,1953470,102,18634
2022-02-17,153,383626,32,88534,472160,3876,676759,37947,1991417,85,18719
2022-02-18,140,383766,20,88554,472320,3243,680002,34291,2025708,72,18791
2022-02-19,95,383861,20,88574,472435,2632,682634,2770,2028478,69,18860
2022-02-20,63,383924,10,88584,472508,2181,684815,13664,2042142,45,18905
2022-02-21,67,383991,18,88602,472593,2101,686916,17550,2059692,52,18957
2022-02-22,41,384032,5,88607,472639,2041,688957,41581,2101273,49,19006
2022-02-23,48,384080,7,88614,472694,2083,691040,38678,2139951,57,19063
2022-02-24,32,384112,6,88620,472732,1835,692875,37817,2177768,50,19113
2022-02-25,31,384143,10,88630,472773,1736,694611,31552,2209320,44,19157
2022-02-26,34,384177,6,88636,472813,843,695454,25544,2234864,29,19186
2022-02-27,27,384204,5,88641,472845,639,696093,13586,2248450,26,19212
2022-02-28,30,384234,5,88646,472880,2428,698521,,2248450,68,19280
2022-03-01,21,384255,11,88657,472912,1746,700267,,2248450,59,19339
2022-03-02,19,384274,8,88665,472939,1752,702019,,2248450,33,19372
2022-03-03,24,384298,7,88672,472970,1707,703726,,2248450,53,19425
2022-03-04,25,384323,6,88678,473001,1690,705416,,2248450,51,19476
2022-03-05,33,384356,9,88687,473043,812,706228,,2248450,32,19508
2022-03-06,21,384377,5,88692,473069,670,706898,,2248450,25,19533
2022-03-07,26,384403,6,88698,473101,2839,709737,,2248450,67,19600
2022-03-08,23,384426,3,88701,473127,2052,711789,,2248450,58,19658
2022-03-09,28,384454,6,88707,473161,2117,713906,,2248450,71,19729
2022-03-10,20,384474,2,88709,473183,1975,715881,,2248450,56,19785
2022-03-11,25,384499,3,88712,473211,2101,717982,,2248450,64,19849
2022-03-12,28,384527,2,88714,473241,959,718941,,2248450,34,19883
2022-03-13,22,384549,2,88716,473265,808,719749,,2248450,33,19916
2022-03-14,35,384584,8,88724,473308,3809,723558,,2248450,112,20028
2022-03-15,22,384606,2,88726,473332,2773,726331,,2248450,75,20103
2022-03-16,35,384641,13,88739,473380,2799,729130,,2248450,86,20189
2022-03-17,37,384678,2,88741,473419,2784,731914,,2248450,82,20271
2022-03-18,39,384717,6,88747,473464,2885,734799,,2248450,95,20366
2022-03-19,27,384744,4,88751,473495,1289,736088,,2248450,47,20413
2022-03-20,25,384769,5,88756,473525,972,737060,,2248450,36,20449
2022-03-21,38,384807,8,88764,473571,4610,741670,,2248450,140,20589
2022-03-22,38,384845,4,88768,473613,3190,744860,,2248450,96,20685
2022-03-23,31,384876,6,88774,473650,2981,747841,,2248450,76,20761
2022-03-24,20,384896,8,88782,473678,2648,750489,,2248450,72,20833
2022-03-25,31,384927,8,88790,473717,2795,753284,,2248450,84,20917
2022-03-26,25,384952,8,88798,473750,1095,754379,,2248450,38,20955
2022-03-27,16,384968,0,88798,473766,985,755364,,2248450,28,20983
2022-03-28,40,385008,2,88800,473808,4178,759542,,2248450,127,21110
2022-03-29,31,385039,4,88804,473843,2865,762407,,2248450,110,21220
2022-03-30,31,385070,4,88808,473878,2637,765044,,2248450,73,21293
2022-03-31,32,385102,6,88814,473916,2309,767353,,2248450,84,21377
2022-04-01,33,385135,5,88819,473954,2225,769578,,2248450,69,21446
2022-04-02,23,385158,4,88823,473981,826,770404,,2248450,26,21472
2022-04-03,27,385185,9,88832,474017,865,771269,,2248450,20,21492
2022-04-04,32,385217,4,88836,474053,3225,774494,,2248450,87,21579
2022-04-05,35,385252,4,88840,474092,2129,776623,,2248450,64,21643
2022-04-06,30,385282,2,88842,474124,2001,778624,,2248450,62,21705
2022-04-07,35,385317,3,88845,474162,1711,780335,,2248450,53,21758
2022-04-08,27,385344,5,88850,474194,1694,782029,,2248450,46,21804
2022-04-09,24,385368,6,88856,474224,720,782749,,2248450,29,21833
2022-04-10,26,385394,2,88858,474252,536,783285,,2248450,19,21852
2022-04-11,31,385425,4,88862,474287,2526,785811,,2248450,55,21907
2022-04-12,31,385456,0,88862,474318,1562,787373,,2248450,53,21960
2022-04-13,28,385484,3,88865,474349,1430,788803,,2248450,39,21999
2022-04-14,20,385504,1,88866,474370,1244,790047,,2248450,36,22035
2022-04-15,28,385532,2,88868,474400,1251,791298,,2248450,28,22063
2022-04-16,26,385558,1,88869,474427,532,791830,,2248450,20,22083
2022-04-17,18,385576,2,88871,474447,308,792138,,2248450,11,22094
2022-04-18,10,385586,1,88872,474458,460,792598,,2248450,11,22105
2022-04-19,31,385617,5,88877,474494,1949,794547,,2248450,58,22163
2022-04-20,25,385642,2,88879,474521,1183,795730,,2248450,29,22192
2022-04-21,35,385677,2,88881,474558,1022,796752,,2248450,30,22222
2022-04-22,33,385710,4,88885,474595,990,797742,,2248450,16,22238
2022-04-23,19,385729,4,88889,474618,442,798184,,2248450,17,22255
2022-04-24,14,385743,0,88889,474632,285,798469,,2248450,6,22261
2022-04-25,18,385761,3,88892,474653,1372,799841,,2248450,50,22311
2022-04-26,26,385787,1,88893,474680,1051,800892,,2248450,28,22339
2022-04-27,20,385807,0,88893,474700,235,801127,,2248450,8,22347
2022-04-28,21,385828,8,88901,474729,1072,802199,,2248450,44,22391
2022-04-29,30,385858,2,88903,474761,886,803085,,2248450,21,22412
2022-04-30,15,385873,2,88905,474778,429,803514,,2248450,18,22430
2022-05-01,17,385890,6,88911,474801,165,803679,,2248450,5,22435
2022-05-02,20,385910,3,88914,474824,448,804127,,2248450,31,22466
2022-05-03,20,385930,2,88916,474846,1393,805520,,2248450,40,22506
2022-05-04,19,385949,5,88921,474870,895,806415,,2248450,29,22535
2022-05-05,16,385965,2,88923,474888,666,807081,,2248450,28,22563
2022-05-06,23,385988,3,88926,474914,680,807761,,2248450,28,22591
2022-05-07,23,386011,1,88927,474938,297,808058,,2248450,15,22606
2022-05-08,7,386018,1,88928,474946,152,808210,,2248450,3,22609
2022-05-09,20,386038,0,88928,474966,948,809158,,2248450,36,22645
2022-05-10,18,386056,2,88930,474986,673,809831,,2248450,22,22667
2022-05-11,18,386074,3,88933,475007,580,810411,,2248450,20,22687
2022-05-12,14,386088,3,88936,475024,517,810928,,2248450,17,22704
2022-05-13,27,386115,4,88940,475055,547,811475,,2248450,15,22719
2022-05-14,17,386132,0,88940,475072,223,811698,,2248450,9,22728
2022-05-15,11,386143,4,88944,475087,132,811830,,2248450,8,22736
2022-05-16,24,386167,3,88947,475114,698,812528,,2248450,28,22764
2022-05-17,23,386190,3,88950,475140,479,813007,,2248450,16,22780
2022-05-18,11,386201,2,88952,475153,378,813385,,2248450,8,22788
2022-05-19,22,386223,2,88954,475177,380,813765,,2248450,5,22793
2022-05-20,10,386233,2,88956,475189,389,814154,,2248450,10,22803
2022-05-21,15,386248,1,88957,475205,174,814328,,2248450,8,22811
2022-05-22,13,386261,0,88957,475218,75,814403,,2248450,2,22813
2022-05-23,12,386273,1,88958,475231,560,814963,,2248450,21,22834
2022-05-24,24,386297,3,88961,475258,355,815318,,2248450,10,22844
2022-05-25,11,386308,1,88962,475270,323,815641,,2248450,10,22854
2022-05-26,13,386321,6,88968,475289,265,815906,,2248450,12,22866
2022-05-27,14,386335,3,88971,475306,240,816146,,2248450,2,22868
2022-05-28,20,386355,0,88971,475326,95,816241,,2248450,2,22870
2022-05-29,9,386364,2,88973,475337,38,816279,,2248450,,22870
2022-05-30,21,386385,0,88973,475358,379,816658,,2248450,15,22885
2022-05-31,15,386400,2,88975,475375,271,816929,,2248450,12,22897
2022-06-01,10,386410,2,88977,475387,267,817196,,2248450,14,22911
2022-06-02,15,386425,2,88979,475404,238,817434,,2248450,11,22922
2022-06-03,21,386446,2,88981,475427,268,817702,,2248450,6,22928
2022-06-04,14,386460,2,88983,475443,84,817786,,2248450,8,22936
2022-06-05,9,386469,0,88983,475452,61,817847,,2248450,3,22939
2022-06-06,12,386481,1,88984,475465,415,818262,,2248450,16,22955
2022-06-07,7,386488,1,88985,475473,312,818574,,2248450,8,22963
2022-06-08,10,386498,2,88987,475485,289,818863,,2248450,9,22972
2022-06-09,22,386520,3,88990,475510,250,819113,,2248450,10,22982
2022-06-10,18,386538,1,88991,475529,305,819418,,2248450,14,22996
2022-06-11,19,386557,2,88993,475550,120,819538,,2248450,7,23003
2022-06-12,6,386563,1,88994,475557,56,819594,,2248450,3,23006
2022-06-13,15,386578,2,88996,475574,537,820131,,2248450,22,23028
2022-06-14,17,386595,3,88999,475594,433,820564,,2248450,10,23038
2022-06-15,20,386615,2,89001,475616,416,820980,,2248450,7,23045
2022-06-16,12,386627,3,89004,475631,418,821398,,2248450,16,23061
2022-06-17,24,386651,2,89006,475657,455,821853,,2248450,19,23080
2022-06-18,17,386668,4,89010,475678,166,822019,,2248450,4,23084
2022-06-19,14,386682,1,89011,475693,139,822158,,2248450,6,23090
2022-06-20,16,386698,3,89014,475712,756,822914,,2248450,29,23119
2022-06-21,11,386709,2,89016,475725,569,823483,,2248450,25,23144
2022-06-22,14,386723,2,89018,475741,606,824089,,2248450,16,23160
2022-06-23,24,386747,0,89018,475765,565,824654,,2248450,28,23188
2022-06-24,22,386769,2,89020,475789,675,825329,,2248450,25,23213
2022-06-25,11,386780,2,89022,475802,198,825527,,2248450,9,23222
2022-06-26,14,386794,1,89023,475817,146,825673,,2248450,3,23225
2022-06-27,16,386810,4,89027,475837,1055,826728,,2248450,33,23258
2022-06-28,19,386829,4,89031,475860,890,827618,,2248450,35,23293
2022-06-29,21,386850,0,89031,475881,857,828475,,2248450,30,23323
2022-06-30,18,386868,2,89033,475901,759,829234,,2248450,27,23350
2022-07-01,20,386888,2,89035,475923,991,830225,,2248450,38,23388
2022-07-02,21,386909,2,89037,475946,306,830531,,2248450,10,23398
2022-07-03,15,386924,2,89039,475963,217,830748,,2248450,10,23408
2022-07-04,22,386946,7,89046,475992,1627,832375,,2248450,72,23480
2022-07-05,18,386964,4,89050,476014,1280,833655,,2248450,52,23532
2022-07-06,16,386980,3,89053,476033,1318,834973,,2248450,44,23576
2022-07-07,29,387009,3,89056,476065,1151,836124,,2248450,36,23612
2022-07-08,23,387032,3,89059,476091,1311,837435,,2248450,42,23654
2022-07-09,17,387049,2,89061,476110,436,837871,,2248450,11,23665
2022-07-10,21,387070,1,89062,476132,360,838231,,2248450,13,23678
2022-07-11,28,387098,4,89066,476164,2136,840367,,2248450,61,23739
2022-07-12,22,387120,3,89069,476189,1692,842059,,2248450,54,23793
2022-07-13,19,387139,3,89072,476211,1607,843666,,2248450,43,23836
2022-07-14,22,387161,1,89073,476234,1496,845162,,2248450,37,23873
2022-07-15,15,387176,3,89076,476252,1799,846961,,2248450,48,23921
2022-07-16,19,387195,3,89079,476274,593,847554,,2248450,13,23934
2022-07-17,22,387217,3,89082,476299,436,847990,,2248450,11,23945
2022-07-18,26,387243,2,89084,476327,2751,850741,,2248450,70,24015
2022-07-19,30,387273,1,89085,476358,1913,852654,,2248450,60,24075
2022-07-20,18,387291,5,89090,476381,1787,854441,,2248450,42,24117
2022-07-21,24,387315,2,89092,476407,1503,855944,,2248450,46,24163
2022-07-22,21,387336,5,89097,476433,1921,857865,,2248450,26,24189
2022-07-23,15,387351,5,89102,476453,635,858500,,2248450,20,24209
2022-07-24,19,387370,3,89105,476475,412,858912,,2248450,11,24220
2022-07-25,37,387407,5,89110,476517,2770,861682,,2248450,60,24280
2022-07-26,34,387441,4,89114,476555,1761,863443,,2248450,43,24323
2022-07-27,14,387455,2,89116,476571,1859,865302,,2248450,36,24359
2022-07-28,26,387481,5,89121,476602,1319,866621,,2248450,35,24394
2022-07-29,24,387505,4,89125,476630,1717,868338,,2248450,45,24439
2022-07-30,14,387519,3,89128,476647,514,868852,,2248450,17,24456
2022-07-31,16,387535,1,89129,476664,429,869281,,2248450,9,24465
2022-08-01,23,387558,2,89131,476689,2360,871641,,2248450,56,24521
2022-08-02,26,387584,5,89136,476720,1610,873251,,2248450,40,24561
2022-08-03,25,387609,0,89136,476745,1469,874720,,2248450,42,24603
2022-08-04,34,387643,1,89137,476780,1332,876052,,2248450,41,24644
2022-08-05,21,387664,0,89137,476801,1506,877558,,2248450,30,24674
2022-08-06,14,387678,2,89139,476817,490,878048,,2248450,13,24687
2022-08-07,20,387698,4,89143,476841,392,878440,,2248450,9,24696
2022-08-08,34,387732,3,89146,476878,2253,880693,,2248450,52,24748
2022-08-09,24,387756,4,89150,476906,1530,882223,,2248450,29,24777
2022-08-10,15,387771,4,89154,476925,1462,883685,,2248450,35,24812
2022-08-11,21,387792,2,89156,476948,1234,884919,,2248450,27,24839
2022-08-12,29,387821,2,89158,476979,1428,886347,,2248450,31,24870
2022-08-13,15,387836,2,89160,476996,449,886796,,2248450,11,24881
2022-08-14,11,387847,3,89163,477010,429,887225,,2248450,14,24895
2022-08-15,20,387867,5,89168,477035,451,887676,,2248450,11,24906
2022-08-16,25,387892,3,89171,477063,2321,889997,,2248450,50,24956
2022-08-17,20,387912,3,89174,477086,1890,891887,,2248450,39,24995
2022-08-18,24,387936,1,89175,477111,1307,893194,,2248450,23,25018
2022-08-19,38,387974,1,89176,477150,1528,894722,,2248450,37,25055
2022-08-20,29,388003,2,89178,477181,483,895205,,2248450,15,25070
2022-08-21,10,388013,0,89178,477191,388,895593,,2248450,17,25087
2022-08-22,24,388037,4,89182,477219,2090,897683,,2248450,48,25135
2022-08-23,31,388068,3,89185,477253,1422,899105,,2248450,31,25166
2022-08-24,26,388094,1,89186,477280,1467,900572,,2248450,29,25195
2022-08-25,19,388113,1,89187,477300,1198,901770,,2248450,20,25215
2022-08-26,17,388130,3,89190,477320,1441,903211,,2248450,30,25245
2022-08-27,23,388153,6,89196,477349,497,903708,,2248450,10,25255
2022-08-28,19,388172,1,89197,477369,347,904055,,2248450,16,25271
2022-08-29,30,388202,2,89199,477401,2008,906063,,2248450,56,25327
2022-08-30,26,388228,3,89202,477430,1402,907465,,2248450,29,25356
2022-08-31,20,388248,1,89203,477451,1449,908914,,2248450,34,25390
2022-09-01,16,388264,1,89204,477468,1143,910057,,2248450,14,25404
2022-09-02,22,388286,2,89206,477492,1247,911304,,2248450,27,25431
2022-09-03,15,388301,1,89207,477508,473,911777,,2248450,12,25443
2022-09-04,13,388314,2,89209,477523,389,912166,,2248450,4,25447
2022-09-05,22,388336,2,89211,477547,2293,914459,,2248450,48,25495
2022-09-06,21,388357,2,89213,477570,1679,916138,,2248450,29,25524
2022-09-07,24,388381,0,89213,477594,1806,917944,,2248450,26,25550
2022-09-08,19,388400,2,89215,477615,1454,919398,,2248450,27,25577
2022-09-09,20,388420,1,89216,477636,1878,921276,,2248450,38,25615
2022-09-10,12,388432,3,89219,477651,600,921876,,2248450,16,25631
2022-09-11,24,388456,3,89222,477678,528,922404,,2248450,14,25645
2022-09-12,22,388478,4,89226,477704,3225,925629,,2248450,44,25689
2022-09-13,19,388497,5,89231,477728,2241,927870,,2248450,43,25732
2022-09-14,20,388517,5,89236,477753,2199,930069,,2248450,50,25782
2022-09-15,18,388535,3,89239,477774,1927,931996,,2248450,36,25818
2022-09-16,19,388554,8,89247,477801,2194,934190,,2248450,42,25860
2022-09-17,20,388574,3,89250,477824,673,934863,,2248450,16,25876
2022-09-18,19,388593,1,89251,477844,592,935455,,2248450,18,25894
2022-09-19,35,388628,2,89253,477881,3131,938586,,2248450,61,25955
2022-09-20,20,388648,2,89255,477903,2223,940809,,2248450,43,25998
2022-09-21,21,388669,4,89259,477928,2246,943055,,2248450,41,26039
2022-09-22,19,388688,2,89261,477949,1769,944824,,2248450,33,26072
2022-09-23,17,388705,2,89263,477968,2033,946857,,2248450,39,26111
2022-09-24,11,388716,0,89263,477979,678,947535,,2248450,16,26127
2022-09-25,17,388733,2,89265,477998,671,948206,,2248450,14,26141
2022-09-26,22,388755,2,89267,478022,3596,951802,,2248450,89,26230
2022-09-27,27,388782,6,89273,478055,2502,954304,,2248450,61,26291
2022-09-28,14,388796,7,89280,478076,2349,956653,,2248450,84,26375
2022-09-29,55,388851,17,89297,478148,2061,958714,,2248450,70,26445
2022-09-30,36,388887,8,89305,478192,2331,961045,,2248450,61,26506
2022-10-01,32,388919,6,89311,478230,836,961881,,2248450,27,26533
2022-10-02,27,388946,2,89313,478259,763,962644,,2248450,22,26555
2022-10-03,38,388984,35,89348,478332,3639,966283,,2248450,96,26651
2022-10-04,42,389026,9,89357,478383,2694,968977,,2248450,49,26700
2022-10-05,39,389065,8,89365,478430,2419,971396,,2248450,,26700
2022-10-06,29,389094,8,89373,478467,2061,973457,,2248450,4,26704
2022-10-07,37,389131,4,89377,478508,2279,975736,,2248450,5,26709
2022-10-08,33,389164,4,89381,478545,835,976571,,2248450,7,26716
2022-10-09,21,389185,5,89386,478571,753,977324,,2248450,6,26722
2022-10-10,33,389218,2,89388,478606,3440,980764,,2248450,18,26740
2022-10-11,30,389248,11,89399,478647,2132,982896,,2248450,8,26748
2022-10-12,31,389279,4,89403,478682,2050,984946,,2248450,19,26767
2022-10-13,17,389296,0,89403,478699,1692,986638,,2248450,7,26774
2022-10-14,23,389319,3,89406,478725,1853,988491,,2248450,10,26784
2022-10-15,15,389334,1,89407,478741,556,989047,,2248450,6,26790
2022-10-16,13,389347,4,89411,478758,590,989637,,2248450,2,26792
2022-10-17,17,389364,4,89415,478779,2695,992332,,2248450,16,26808
2022-10-18,24,389388,2,89417,478805,1744,994076,,2248450,12,26820
2022-10-19,24,389412,1,89418,478830,1542,995618,,2248450,9,26829
2022-10-20,17,389429,5,89423,478852,1341,996959,,2248450,10,26839
2022-10-21,16,389445,3,89426,478871,269,997228,,2248450,2,26841
2022-10-22,17,389462,7,89433,478895,240,997468,,2248450,3,26844
2022-10-23,18,389480,2,89435,478915,493,997961,,2248450,4,26848
2022-10-24,18,389498,5,89440,478938,1993,999954,,2248450,45,26893
2022-10-25,20,389518,1,89441,478959,1363,1001317,,2248450,18,26911
2022-10-26,16,389534,2,89443,478977,1226,1002543,,2248450,18,26929
2022-10-27,13,389547,6,89449,478996,909,1003452,,2248450,16,26945
2022-10-28,27,389574,0,89449,479023,960,1004412,,2248450,16,26961
2022-10-29,14,389588,0,89449,479037,300,1004712,,2248450,7,26968
2022-10-30,15,389603,0,89449,479052,334,1005046,,2248450,9,26977
2022-10-31,16,389619,2,89451,479070,376,1005422,,2248450,15,26992
2022-11-01,11,389630,2,89453,479083,273,1005695,,2248450,2,26994
2022-11-02,11,389641,2,89455,479096,1391,1007086,,2248450,31,27025
2022-11-03,18,389659,1,89456,479115,916,1008002,,2248450,22,27047
2022-11-04,26,389685,2,89458,479143,781,1008783,,2248450,16,27063
2022-11-05,16,389701,1,89459,479160,227,1009010,,2248450,6,27069
2022-11-06,10,389711,3,89462,479173,233,1009243,,2248450,5,27074
2022-11-07,10,389721,3,89465,479186,1080,1010323,,2248450,17,27091
2022-11-08,17,389738,3,89468,479206,761,1011084,,2248450,17,27108
2022-11-09,9,389747,1,89469,479216,694,1011778,,2248450,11,27119
2022-11-10,16,389763,2,89471,479234,490,1012268,,2248450,12,27131
2022-11-11,18,389781,1,89472,479253,626,1012894,,2248450,13,27144
2022-11-12,16,389797,2,89474,479271,158,1013052,,2248450,5,27149
2022-11-13,19,389816,2,89476,479292,240,1013292,,2248450,2,27151
2022-11-14,17,389833,4,89480,479313,1099,1014391,,2248450,19,27170
2022-11-15,22,389855,3,89483,479338,869,1015260,,2248450,20,27190
2022-11-16,13,389868,1,89484,479352,813,1016073,,2248450,24,27214
2022-11-17,14,389882,2,89486,479368,729,1016802,,2248450,19,27233
2022-11-18,15,389897,1,89487,479384,876,1017678,,2248450,14,27247
2022-11-19,15,389912,0,89487,479399,276,1017954,,2248450,7,27254
2022-11-20,18,389930,4,89491,479421,245,1018199,,2248450,2,27256
2022-11-21,19,389949,4,89495,479444,1435,1019634,,2248450,29,27285
2022-11-22,13,389962,1,89496,479458,1082,1020716,,2248450,10,27295
2022-11-23,21,389983,2,89498,479481,1004,1021720,,2248450,20,27315
2022-11-24,19,390002,2,89500,479502,946,1022666,,2248450,16,27331
2022-11-25,14,390016,1,89501,479517,1039,1023705,,2248450,24,27355
2022-11-26,12,390028,0,89501,479529,362,1024067,,2248450,12,27367
2022-11-27,13,390041,1,89502,479543,361,1024428,,2248450,7,27374
2022-11-28,15,390056,1,89503,479559,1814,1026242,,2248450,34,27408
2022-11-29,32,390088,1,89504,479592,1439,1027681,,2248450,36,27444
2022-11-30,18,390106,0,89504,479610,1467,1029148,,2248450,20,27464
2022-12-01,22,390128,2,89506,479634,1182,1030330,,2248450,29,27493
2022-12-02,23,390151,2,89508,479659,1339,1031669,,2248450,29,27522
2022-12-03,18,390169,0,89508,479677,476,1032145,,2248450,18,27540
2022-12-04,10,390179,4,89512,479691,415,1032560,,2248450,12,27552
2022-12-05,16,390195,3,89515,479710,2348,1034908,,2248450,35,27587
2022-12-06,20,390215,6,89521,479736,1980,1036888,,2248450,47,27634
2022-12-07,14,390229,1,89522,479751,1950,1038838,,2248450,32,27666
2022-12-08,14,390243,2,89524,479767,1578,1040416,,2248450,27,27693
2022-12-09,14,390257,4,89528,479785,1733,1042149,,2248450,25,27718
2022-12-10,18,390275,0,89528,479803,539,1042688,,2248450,16,27734
2022-12-11,17,390292,2,89530,479822,506,1043194,,2248450,18,27752
2022-12-12,23,390315,2,89532,479847,2659,1045853,,2248450,56,27808
2022-12-13,27,390342,1,89533,479875,2183,1048036,,2248450,55,27863
2022-12-14,16,390358,3,89536,479894,2002,1050038,,2248450,36,27899
2022-12-15,24,390382,0,89536,479918,1695,1051733,,2248450,40,27939
2022-12-16,28,390410,3,89539,479949,1740,1053473,,2248450,33,27972
2022-12-17,17,390427,0,89539,479966,564,1054037,,2248450,15,27987
2022-12-18,8,390435,4,89543,479978,539,1054576,,2248450,7,27994
2022-12-19,15,390450,2,89545,479995,2556,1057132,,2248450,43,28037
2022-12-20,10,390460,0,89545,480005,2199,1059331,,2248450,35,28072
2022-12-21,20,390480,2,89547,480027,2587,1061918,,2248450,34,28106
2022-12-22,20,390500,2,89549,480049,1235,1063153,,2248450,34,28140
2022-12-23,18,390518,1,89550,480068,1680,1064833,,2248450,32,28172
2022-12-24,24,390542,0,89550,480092,543,1065376,,2248450,18,28190
2022-12-25,24,390566,1,89551,480117,264,1065640,,2248450,10,28200
2022-12-26,19,390585,2,89553,480138,549,1066189,,2248450,10,28210
2022-12-27,19,390604,3,89556,480160,2260,1068449,,2248450,60,28270
2022-12-28,20,390624,3,89559,480183,1551,1070000,,2248450,23,28293
2022-12-29,20,390644,1,89560,480204,1126,1071126,,2248450,22,28315
2022-12-30,19,390663,2,89562,480225,1100,1072226,,2248450,13,28328
2022-12-31,6,390669,0,89562,480231,338,1072564,,2248450,2,28330
2023-01-01,8,390677,1,89563,480240,168,1072732,,2248450,6,28336
2023-01-02,18,390695,2,89565,480260,464,1073196,,2248450,12,28348
2023-01-03,23,390718,2,89567,480285,1775,1074971,,2248450,46,28394
2023-01-04,22,390740,2,89569,480309,1230,1076201,,2248450,18,28412
2023-01-05,21,390761,2,89571,480332,779,1076980,,2248450,16,28428
2023-01-06,17,390778,1,89572,480350,808,1077788,,2248450,12,28440
2023-01-07,20,390798,1,89573,480371,203,1077991,,2248450,5,28445
2023-01-08,22,390820,4,89577,480397,190,1078181,,2248450,4,28449
2023-01-09,16,390836,0,89577,480413,818,1078999,,2248450,19,28468
2023-01-10,8,390844,2,89579,480423,624,1079623,,2248450,15,28483
2023-01-11,17,390861,1,89580,480441,509,1080132,,2248450,10,28493
2023-01-12,21,390882,2,89582,480464,405,1080537,,2248450,5,28498
2023-01-13,11,390893,1,89583,480476,423,1080960,,2248450,2,28500
2023-01-14,24,390917,1,89584,480501,100,1081060,,2248450,3,28503
2023-01-15,5,390922,2,89586,480508,94,1081154,,2248450,2,28505
2023-01-16,15,390937,1,89587,480524,476,1081630,,2248450,4,28509
2023-01-17,13,390950,1,89588,480538,369,1081999,,2248450,7,28516
2023-01-18,20,390970,1,89589,480559,308,1082307,,2248450,3,28519
2023-01-19,11,390981,1,89590,480571,225,1082532,,2248450,4,28523
2023-01-20,13,390994,1,89591,480585,254,1082786,,2248450,2,28525
2023-01-21,18,391012,1,89592,480604,71,1082857,,2248450,2,28527
2023-01-22,14,391026,3,89595,480621,72,1082929,,2248450,3,28530
2023-01-23,12,391038,1,89596,480634,316,1083245,,2248450,,28530
2023-01-24,8,391046,1,89597,480643,285,1083530,,2248450,3,28533
2023-01-25,16,391062,0,89597,480659,255,1083785,,2248450,5,28538
2023-01-26,9,391071,2,89599,480670,198,1083983,,2248450,4,28542
2023-01-27,16,391087,0,89599,480686,229,1084212,,2248450,3,28545
2023-01-28,8,391095,1,89600,480695,54,1084266,,2248450,1,28546
2023-01-29,7,391102,1,89601,480703,59,1084325,,2248450,2,28548
2023-01-30,13,391115,0,89601,480716,305,1084630,,2248450,4,28552
2023-01-31,20,391135,0,89601,480736,226,1084856,,2248450,6,28558
2023-02-01,14,391149,1,89602,480751,218,1085074,,2248450,7,28565
2023-02-02,14,391163,2,89604,480767,179,1085253,,2248450,5,28570
2023-02-03,17,391180,1,89605,480785,204,1085457,,2248450,5,28575
2023-02-04,5,391185,0,89605,480790,34,1085491,,2248450,2,28577
2023-02-05,11,391196,1,89606,480802,41,1085532,,2248450,1,28578
2023-02-06,11,391207,0,89606,480813,261,1085793,,2248450,9,28587
2023-02-07,24,391231,2,89608,480839,196,1085989,,2248450,4,28591
2023-02-08,11,391242,0,89608,480850,55,1086044,,2248450,3,28594
2023-02-09,14,391256,2,89610,480866,205,1086249,,2248450,6,28600
2023-02-10,12,391268,0,89610,480878,205,1086454,,2248450,4,28604
2023-02-11,15,391283,1,89611,480894,48,1086502,,2248450,1,28605
2023-02-12,11,391294,0,89611,480905,42,1086544,,2248450,1,28606
2023-02-13,18,391312,1,89612,480924,323,1086867,,2248450,3,28609
2023-02-14,16,391328,2,89614,480942,239,1087106,,2248450,6,28615
2023-02-15,18,391346,2,89616,480962,218,1087324,,2248450,8,28623
2023-02-16,12,391358,4,89620,480978,205,1087529,,2248450,3,28626
2023-02-17,21,391379,1,89621,481000,216,1087745,,2248450,2,28628
2023-02-18,11,391390,2,89623,481013,61,1087806,,2248450,,28628
2023-02-19,11,391401,1,89624,481025,56,1087862,,2248450,,28628
2023-02-20,10,391411,0,89624,481035,369,1088231,,2248450,11,28639
2023-02-21,22,391433,0,89624,481057,268,1088499,,2248450,3,28642
2023-02-22,14,391447,1,89625,481072,296,1088795,,2248450,7,28649
2023-02-23,12,391459,1,89626,481085,263,1089058,,2248450,5,28654
2023-02-24,16,391475,2,89628,481103,296,1089354,,2248450,4,28658
2023-02-25,15,391490,1,89629,481119,84,1089438,,2248450,4,28662
2023-02-26,16,391506,3,89632,481138,67,1089505,,2248450,1,28663
2023-02-27,12,391518,0,89632,481150,505,1090010,,2248450,12,28675
2023-02-28,15,391533,2,89634,481167,380,1090390,,2248450,7,28682
2023-03-01,12,391545,1,89635,481180,361,1090751,,2248450,5,28687
2023-03-02,15,391560,0,89635,481195,276,1091027,,2248450,9,28696
2023-03-03,20,391580,0,89635,481215,341,1091368,,2248450,7,28703
2023-03-04,11,391591,2,89637,481228,78,1091446,,2248450,2,28705
2023-03-05,6,391597,2,89639,481236,77,1091523,,2248450,,28705
2023-03-06,14,391611,0,89639,481250,589,1092112,,2248450,13,28718
2023-03-07,10,391621,1,89640,481261,471,1092583,,2248450,3,28721
2023-03-08,11,391632,0,89640,481272,445,1093028,,2248450,7,28728
2023-03-09,12,391644,1,89641,481285,343,1093371,,2248450,3,28731
2023-03-10,15,391659,2,89643,481302,425,1093796,,2248450,5,28736
2023-03-11,12,391671,1,89644,481315,95,1093891,,2248450,2,28738
2023-03-12,8,391679,0,89644,481323,89,1093980,,2248450,1,28739
2023-03-13,18,391697,0,89644,481341,684,1094664,,2248450,15,28754
2023-03-14,18,391715,1,89645,481360,449,1095113,,2248450,8,28762
2023-03-15,11,391726,2,89647,481373,440,1095553,,2248450,8,28770
2023-03-16,14,391740,1,89648,481388,368,1095921,,2248450,9,28779
2023-03-17,16,391756,1,89649,481405,413,1096334,,2248450,7,28786
2023-03-18,16,391772,0,89649,481421,50,1096384,,2248450,2,28788
2023-03-19,7,391779,2,89651,481430,87,1096471,,2248450,2,28790
2023-03-20,16,391795,0,89651,481446,642,1097113,,2248450,10,28800
2023-03-21,16,391811,0,89651,481462,462,1097575,,2248450,5,28805
2023-03-22,13,391824,1,89652,481476,483,1098058,,2248450,9,28814
2023-03-23,16,391840,2,89654,481494,359,1098417,,2248450,8,28822
2023-03-24,19,391859,2,89656,481515,413,1098830,,2248450,4,28826
2023-03-25,13,391872,1,89657,481529,85,1098915,,2248450,1,28827
2023-03-26,11,391883,1,89658,481541,63,1098978,,2248450,1,28828
2023-03-27,14,391897,2,89660,481557,542,1099520,,2248450,13,28841
2023-03-28,11,391908,1,89661,481569,382,1099902,,2248450,5,28846
2023-03-29,14,391922,2,89663,481585,410,1100312,,2248450,6,28852
2023-03-30,12,391934,2,89665,481599,277,1100589,,2248450,12,28864
2023-03-31,15,391949,0,89665,481614,44,1100633,,2248450,2,28866
